KEY	영어	한국어	중국어(간체)
locale	en	ko	zh-Hans
			
AppDelegate:alertDiskFull	Not enough memory.\nPlease delete some of your data.	단말 저장 공간이 부족합니다.\n저장 공간을 확보한 후\n다시 시도해 주세요.	您的终端存储空间不足。\n请确保更多空间后重试。
			
ULocalStorage:systemName	My Document	내 문서	我的文件
			
UDrive:upfolder	Upper Folder	상위 폴더	上级文件夹
			
EPDFTocController:Table of Contents	Table of Contents	목차	目录
EPDFTocController:Contents None	No content.	항목 없음	没有目录
EPDFTocController:btnDone	Close	닫기	关闭
			
EViewDrawController:lblNoDrawingObject	Drawn object has not been found in the document.	문서 안에 포함된 드로잉 객체가 없습니다.	文件内没有图形对象！
			
evEnginePL:addSubTitle	Enter a subtitle.	부제목을 입력해 주세요.	请输入副标题
evEnginePL:addText	Enter text.	텍스트를 입력해 주세요.	请输入文本
evEnginePL:addTitle	Enter a title.	제목을 입력해 주세요.	请输入标题
			
FWebView:close	Close	닫기	关闭
FWebView:btnShowAgain	Do not show this again	다시 보지 않기	不再提示
			
PopWebView:close	Close	닫기	关闭
PopWebView:btnShowAgain	Do not show this again	다시 보지 않기	不再提示
			
PopMyImage:btnTakePicture	Take a picture	사진 촬영	照相
PopMyImage:btnCameraRoll	Camera Roll	카메라 롤	相机胶卷
PopMyImage:btnCancel	Cancel	취소	取消
			
FTemplateVC:btnBack	Back	이전	返回
FTemplateVC:btnClose	Close	닫기	关闭
FTemplateVC:lblTitle	Select Template	템플릿 선택	选择模板
FTemplateVC:lblEmpty	Blank	Blank	空白
			
FSettingMain:lblTitle	Settings	설정	设置
FSettingMain:btnConfirm	Done	완료	完成
FSettingMain:btnDone	Close	닫기	关闭
FSettingMain:lblTransfer	Transfer File	파일 전송	发送文件
FSettingMain:btnTransfer	Transfer File	파일 전송	发送文件
FSettingMain:btnSaveOrNot	Confirm Save	저장 여부 확인	确认保存状态
FSettingMain:btnExtention	Show Extensions	확장자 보이기	显示扩展名
FSettingMain:btnMode	Basic Mode	문서 기본 모드	文件常规模式
FSettingMain:btnAutoRestore	Auto Recovery	자동 복구	自动修复
FSettingMain:btnShowGuide	Show Guidelines	가이드 보이기	显示向导
FSettingMain:btnType	New Document Type	새 문서 형식	新建文件格式
FSettingMain:btnCellular	Use Cellular Data	셀룰러 데이터 사용	使用蜂窝移动数据
FSettingMain:lblCellular	Use cellular data to synchronize files\nif a Wi-Fi network is not available.	파일 동기화 시 Wi-Fi가 연결되지 않은 경우\n셀룰러 데이터를 사용하여 동기화합니다.	同步文件时没有连接 Wi-Fi，则会使用蜂窝移动数据进行同步。
FSettingMain:lblInfo	Product Information	Polaris Office 정보	Polaris Office 信息
FSettingMain:lblLinkInfo	Polaris Office Information	Polaris Office 정보	Polaris Office 信息
FSettingMain:btnNoti	Notice	공지사항	公告
FSettingMain:btnFAQ	FAQ	FAQ	常见问题解答
FSettingMain:btnSupport	Customer Support	고객센터	用户支持
FSettingMain:btnAbout	v%@ (build %@)	v%@ (build %@)	v%@ (build %@)
FSettingMain:btnEULA	EULA	EULA	最终用户许可协议
FSettingMain:btnCopyright	Copyright	Copyright	版权声明
FSettingMain:btnTransfer	File Transfer	파일 전송	发送文件
FSettingMain:lblCloud	Polaris Office	Polaris Office	Polaris Office
FSettingMain:lblCloudSetting	Polaris Office Settings	Polaris Office 설정	Polaris Office 设置
FSettingMain:lblSetting	General Settings	일반 설정	常规设置
FSettingMain:btnUsageDrive	Cloud Space	클라우드 공간	云盘空间
FSettingMain:btnAutoSync	Auto Synchronization	자동 동기화	自动同步
FSettingMain:btnEmptyTrash	Empty Trashbox	휴지통 비우기	清空回收站
FSettingMain:btnUpgrade	Upgrade Account	계정 업그레이드	升级账户
FSettingMain:btnPremium	Service Introduction	서비스 소개	业务介绍
FSettingMain:btnLogout	Sign Out	로그아웃	注销
FSettingMain:lblEditPicture	EDIT	편집	编辑
FSettingMain:btnBack	Settings	설정	设置
FSettingMain:usageText	Turn Off	사용 안함	不使用
FSettingMain:on	Enable	켬	开启
FSettingMain:off	Disable	끔	关闭
FSettingMain:logout	Do you want to sign out?	로그아웃 하시겠습니까?	确定要注销吗？
FSettingMain:logoutnonsync	Unsynchronized files wil be deleted if you sign out now. \n Do you still want to sign out?	아직 동기화되지 않은 문서가 있습니다.\n로그아웃을 하실 경우 해당문서는 삭제됩니다.\n로그아웃 하시겠습니까?	还有未同步的文件。\n退出登录时，将会被删除。\n要退出登录吗？
FSettingMain:deletetrash	Do you want to permanently delete all the items in Trashbox?	휴지통의 모든 항목을 영구적으로 삭제하시겠습니까?	要永久删除回收站内所有文件吗？
FSettingMain:btnContacts	Manage Address Book	주소록 관리	管理通讯录
FSettingMain:btnInitContact.login	Logged in at %@	%@에 로그인	%@ 登录
FSettingMain:btnInitContact.sync	Address book last synchronized at %@	%@에 주소록 동기화	%@ 同步通讯录
FSettingMain:btnInitContact.login.dateformat	HH:mm, yyyy-MM-dd.	yyyy.MM.dd HH:mm	yyyy-MM-dd HH:mm
FSettingMain:btnInitContact.sync.dateformat	HH:mm, yyyy-MM-dd.	yyyy.MM.dd HH:mm	yyyy-MM-dd HH:mm
FSettingMain:lblInfoIntro	Product Introduction	제품 안내 및 소개하기	产品介绍
FSettingMain:btnInquiry	Customer Support	고객센터	用户中心
FSettingMain:lblIntro	Introduction	소개하기	介绍
FSettingMain:share.facebook.body	I wanted to invite you to try Polaris Office. \nPOLARIS Office is a free office app that allows you to easily create, share, and edit documents anytime and anywhere. Sign up with the link I've sent you and you'll receive additional cloud storage.	Polaris Office를 사용해보니 Microsoft Office 문서를 자주 사용하시는 분께는 정말 필요한 것 같아요. 무료 오피스니까 문서 작업 많이 하시는 분들은 이 링크를 통해서 가입하시고 보너스 용량도 받아보세요.	Polaris Office 对经常使用 Microsoft Office 文件的人来说，是必备工具。点击这个链接注册后，还能获得更多容量。
FSettingMain:share.twitter.body	Polaris Office is a free office app great for creating and editing Microsoft Office documents. Sign up today to get FREE additional storage.	Polaris Office를 사용해보니 Microsoft Office문서를 사용하시는 분께 정말 필요할 것 같아요. 무료로 가입해 보시고 보너스 용량도 받아보세요.	Polaris Office 对经常使用 Microsoft Office 文件的人来说，是必备工具。点击这个链接注册后，还能获得更多容量。
FSettingMain:share.email.title	%@ has invited you to Polaris Office.	%@님이 Polaris Office 사용을 추천하였습니다.	%@<%@> 向您推荐 Polaris Office
FSettingMain:share.email.body	Hi! This is %@.\n\n I wanted to invite you to try Polaris Office. \n\nPOLARIS Office is a free office app that allows you to easily create, share, and edit documents anytime and anywhere. Sign up with the link I've sent you and you'll even receive additional storage. \n\n%@	안녕하세요. %@ 입니다.\n\nPolaris Office를 사용해보니 Microsoft Office 문서를 자주 사용하시는 분께는 정말 필요한 것 같아요. 제 주변 사람들이 많이 사용해서 저도 사용하고 있는데, 제 주소록 목록을 보니 아직 사용하지 않고 계신가봐요?\n\nPolaris Office는 문서를 어디서나 편집하고 쉽게 공유할 수 있는 무료 오피스인데, 문서 작업 많이 하시니까 제가 보낸 링크를 통해서 가입하시고 보너스 용량도 받아보세요.\n\n%@\n\n상단의 링크를 클릭하여 가입한 뒤 이메일 인증을 완료하면 추가 용량이 제공됩니다.	您好，我是%@。\n\n我认为对经常使用 Microsoft Office 文件的人来说，Polaris Office 是一个非常有用的工具。我周边有很多人都在用，我在联系人列表上发现您好像还没有使用 Polaris Office。\nPolaris Office 是可随时随地编辑文件、共享文件的免费 Office，您平时经常处理很多文件，通过我给您发送的链接注册后还能拿到赠送的存储空间。\n\n%@\n\n点击上方链接进行注册后，完成电子邮件地址验证，即可获赠额外的存储空间。
FSettingMain:share.kakao.msg	I wanted to invite you to try Polaris Office. \nPOLARIS Office is a free office app that allows you to easily create, share, and edit documents anytime and anywhere. Sign up with the link I've sent you and you'll receive additional cloud storage.	Polaris Office를 사용해보니 Microsoft Office 문서를 자주 사용하시는 분께는 정말 필요한 것 같아요. 무료 오피스니까 문서 작업 많이 하시는 분들은 이 링크를 통해서 가입하시고 보너스 용량도 받아보세요.	Polaris Office 对经常使用 Microsoft Office 文件的人来说，是必备工具。点击这个链接注册后，还能获得更多容量。
FSettingMain:share.line.msg	Polaris Office is a free office app which is great for creating and editing Microsoft Office documents. Sign up today to get additional FREE storage.\n%@	Polaris Office를 사용해보니 Microsoft Office 문서를 자주 사용하시는 분께는 정말 필요한 것 같아요. 무료 오피스니까 문서 작업 많이 하시는 분들은 이 링크를 통해서 가입하시고 보너스 용량도 받아보세요.\n%@	Polaris Office 对经常使用 Microsoft Office 文件的人来说，是必备工具。点击这个链接注册后，还能获得更多容量。\n%@
FSettingMain:SNSNameFacebook	Facebook	페이스북	Facebook
FSettingMain:SNSNameTwitter	Twitter	트위터	Twitter
FSettingMain:lblProductInfo	Product Information	제품 정보	产品信息
FSettingMain:btnSleepOff	Sleep Mode	슬립 모드	睡眠模式
FSettingMain:btnAdSub3	Feedback	문의하기	提问
FSettingMain:SNSConfigureNeeded	Register %@ account\nand try it again.	%@ 계정 설정 후 다시 시도해주세요.	请设置 %@ 账户后重试
FSettingMain:lblGradeUsage	Service Subscriber	서비스 사용중	服务使用中
FSettingMain:lblFree	Free	Free	免费
FSettingMain:lblPremium	Premium	Premium	高级
FSettingMain:btnBonusStorage	Get More Storage	추가 용량 받기	获取更多容量
FSettingMain:lblRecommendSupport	Support	추천 및 지원	推荐及用户支持
FSettingMain:btnMyDevice	My Devices	내 장치	我的设备
FSettingMain:btnAddress	Address Book	주소록 관리	管理通讯录
FSettingMain:btnReview	Review	평가하기	发表评论
FSettingMain:btnRecommand	Get More Storage	추가 용량 받기	获取更多容量
FSettingMain:lblUsing	Using	사용중	使用中
FSettingMain:lblEdit	Edit	편집	编辑
FSettingMain:lblDueDate	Available until	까지 이용가능	到期
FSettingMain:Alert_NetworkDisconnected	You are not connected to a network. Please check your internet \n connection or Wi-Fi setting.	네트워크 연결이 꺼져 있습니다.\n셀룰러 데이터 또는 Wi-Fi 연결 후\n사용해 주세요.	网络连接已断开！\n请在连接蜂窝移动数据或 Wi-Fi 后使用。
FSettingMain:Error_AIRPLANE	Please turn off Airplane mode to access your data.	데이터에 접근하려면, \n에어플레인 모드를 해제해 주세요.	要访问数据，请先解除飞行模式。
FSettingMain:LinkError	The network is busy.\nPlease try it again later.	네트워크 상태가 원활하지 않습니다.\n잠시 후 다시 시도해 주세요.	网络状态不稳定，请稍后再试
FSettingMain:lblChnageName	Change Name	이름 변경	更改昵称
FSettingMain:lblChnagePass	Change Password	비밀번호 변경	更改密码
FSettingMain:lblRecommend	Recommend	추천하기	推荐
FSettingMain:btnLockMode	Set Passcode	잠금 설정	锁定设置
FSettingMain:lblSetupPass	Set Password	비밀번호 설정	设置密码
FSettingMain:lblPOSIntall	Polaris Office for PCs	Desktop용 Polaris Office	用于计算机的 Polaris Office Sync
			
FObjBrowserVC:newFolder	New Folder	새 폴더	新建文件夹
FObjBrowserVC:errorSync	This file is not synchronized.\nPlease synchronize it first.	동기화가 되지 않은 파일입니다.\n동기화 후 진행바랍니다.	尚未同步的文件！\n请完成同步后进行。
			
FObjCell:btnCancel	Cancel	취소	取消
FObjCell:maxLength	The text amount exceeded the maximum character limit.	제한된 글자수를 초과하였습니다.	已超过限制的字符数！
FObjCell:sameFolder	\%@\\nalready exists.\nPlease try a different name.	\'%@\'\n이/가 존재합니다.\n다른 이름으로 저장 해 주세요.	\%@\"\n已存在！\n请用其他名称保存。"
FObjCell:sameFile	\%@.%@\\nalready exists.\nPlease try a different name.	\'%@.%@\'\n이/가 존재합니다.\n다른 이름으로 저장 해 주세요.	\%@.%@\"\n已存在！\n请用其他名称保存。"
FObjCell:zeroLengthFile	Enter a filename.	파일명을 입력해주세요.	请输入文件名
FObjCell:zeroLengthFolder	Enter a folder name.	폴더명을 입력해주세요.	请输入文件夹名
FObjCell:specialCharacter	Special characters (\\, /, :, *, ?, \, “, <, >, and |)\ncannot be used.	특수문자 (\\ / : * ? \ “ < > |)는\n사용할 수 없습니다.	不能使用特殊字符 (\\ / : * ? \ “ < > |)！
FObjCell:unsupportedString	.. cannot be used.	..'문자는 사용할 수 없습니다.	不能使用\..\"！"
FObjCell:unsupportedStringdot	. cannot be used at the folder names.	.'문자는 폴더이름에 사용할 수 없습니다.	\.\"不能用于文件夹名！"
			
PopSettingInform:btnTwitter	Post on Twitter	Twitter로 알리기	通过 Twitter 发送
PopSettingInform:btnFacebook	Post on Facebook	Facebook으로 알리기	通过 Facebook 发送
PopSettingInform:btnEmail	Send E-mail	E-mail로 알리기	通过电子邮件发送
PopSettingInform:btnCancel	Cancel	취소	取消
			
FContactList:close	Close	닫기	关闭
FContactList:sync	Sync	동기화	同步
FContactList:lblContactList	Contacts	주소록 관리	管理通讯录
FContactList:contactTab	Address Book	주소록	通讯录
FContactList:hiddenTab	Hidden Lists	숨김 목록	隐藏列表
FContactList:hide	Hide	숨기기	隐藏
FContactList:unhide	Show	숨김 해제	取消隐藏
FContactList:hidden_fail	Unable to hide the address book.	주소록 숨기기를 할 수 없습니다.	无法隐藏通讯录！
FContactList:show_fail	Unable to show the hidden address book.	주소록 숨기기 해제를 할 수 없습니다.	无法取消通讯录隐藏！
FContactList:syncAddressAlert	Do you want to import the device's contact list to Polaris Office address book?	현재의 계정으로 단말에 있는 주소록을\n취합합니다. 진행 하시겠습니까?	使用当前账户，把设备上的通讯录进行整合。\n要继续吗？
			
FAddressBookManager:ContactAccessAlert	To change access settings of the address book, please go to Privacy > Contacts > Polaris Office.	주소록 접근 설정을 변경하고 싶으시면 개인 정보 보호 > 연락처 > Polaris Office 설정을 활성화 해주세요.	如需更改通讯录访问设置，请在设备的\设置\">\"隐私\">\"通讯录\"中进行设置。"
			
FContactListCell:hide	Hide	숨기기	隐藏
FContactListCell:unhide	Show	숨김 해제	取消隐藏
			
FLicenseVC:lblTitle	Terms and Conditions of Use	사용권 계약 고지	使用权限条款
FLicenseVC:textView	Infraware and the developer per their agreement allows users to use this software on their device. Users may not make and/or duplicate, nor distribute this application illegally. Users will be notified of software updates as well as promotional events regrarding Polaris Office. In order to receive the updates and/or event, Wifi, WLAN, Mobile Data, or some form of internet connection is required to connect to the Infraware server. By agreeing to the terms and conditions of use of this application, users agree to receive such notifications and information sent to them from Infraware. Users are not required to update the application but in the event that users do, they subsequently will agree to any future terms and conditions that come with the updates including but not limited to additional update and promotional information. By agreeing to these terms and condition of use users agree that data regarding the performance and use of the application will be recorded and collected solely for the purposes of logging crash data and to improve user experience. No personal data will be collected or distributed for any means or for any other parties. We respect the privacy of our users.	사용자는 (주)인프라웨어와의 사용권 계약에서 정한 조건에 따라 따라 이 소프트웨어를 사용할 수 있습니다. 사용권 계약의 자세한 내용은 환경설정의 EULA를 참고하시기 바랍니다. 이 소프트웨어는 공지사항을 통해 성능 개선정보, 각종 이벤트 정보를 수신하기 위하여 Wi-Fi 접속 등 일정한 조건이 되면 정기적으로 업데이트 관리 서버와 통신할 수 있습니다.\n\n다음 사항에 동의하면 사용자는 (주)인프라웨어가 제공하는 각종 정보와 서비스를 추가로 받을 수 있습니다. 사용자는 본 계약에 동의하지 않더라도 이 소프트웨어를 사용할 수 있습니다. 이 소프트웨어가 성능 및 사용성 개선을 위한 작동오류정보, 내부 기능에 대한 익명사용통계 등을 기록하고, 업데이트 관리 서버와 통신 시 이를 전송하는 것에 동의합니다.	用户可按照与 INFRAWARE 公司的使用权限条款所规定的条件使用该软件。使用权限条款的详细内容，请参考\设置\"中的\"最终用户许可协议\"。该软件在有 Wi-Fi 连接等一定条件下，会定期连接到升级管理服务器，接收升级、活动等信息。\n\n同意以下内容时，还能额外接收由 INFRAWARE 公司提供的更多信息和服务。用户即使不同意本条款也能正常使用该软件。同意该软件记录用于改善性能及可用性的动作异常信息和对内部功能的匿名使用统计，并在连接升级服务器时上传相关数据。"
FLicenseVC:btnDisagreement	I do not agree	동의 안함	不同意
FLicenseVC:btnAgreement	I agree	동의	同意
			
FSettingInfo:lblError	An unknown error has occurred.\nPlease try it again.	알 수 없는 오류가 발생하였습니다.\n다시 시도해 주세요.	发生未知错误！\n请重试。
			
MAddressBookManager:ContactAccessAlert	To change access settings of the address book, please go to Privacy > Contacts > Polaris Office.	주소록 접근 설정을 변경하고 싶으시면 개인 정보 보호 > 연락처 > Polaris Office 설정을 활성화 해주세요.	如需更改通讯录访问设置，请在设备的\设置\">\"隐私\">\"通讯录\"中进行设置。"
MAddressBookManager:syncAddressAlert	Do you want to import the device's contact list to Polaris Office address book?	현재의 계정으로 단말에 있는 주소록을\n취합합니다. 진행 하시겠습니까?	使用当前账户，把设备上的通讯录进行整合。\n要继续吗？
			
PopCellLock:btnLocked	Locked (%d)	잠금 설정 (%d)	锁定 (%d)
PopCellLock:btnUnlocked	Unlocked (%d)	잠금 해제 (%d)	解锁 (%d)
			
PopContactNotice:notice1	Edit and Share documents with other people. \n\nSync your address book to easily share documents to your friends.\n\nYour address book in Polaris Office is protected and will not be distributed without your permission.	Polaris Office에서 \n문서를 공유하고 협업하세요.\n\n회원님 단말 연락처를 연동하여 지인에게\n 문서를 쉽게 공유할 수 있습니다.\n\nPolaris Office에 저장된\n 이메일 주소록은 안전하게 보관되며\n 회원님의 허가 없이 사용되지 않습니다.	请在 Polaris Office 共享文件并进行协作办公。\n\n调用您的通讯录，可向联系人轻松共享您的文件。\n\n保存在 Polaris Office 的联系人电子邮箱，不会在没有您的许可而用于其他用途。
PopContactNotice:notice2	Upload your device's contact list to Polaris Office address book.\n\nYou may easily share documents to your friends via address book in Polaris Office. \n\nThe uploaded contacts in Polaris Office is encrypted and protected and it will never be used without your permission.	회원님 단말 연락처에 있는 이메일 주소 목록을\n Polaris Office 서버에 업로드 합니다.\n\n언제 어디서나 Polaris Office 서비스에\n 로그인하면 업로드했던 주소록을 통해\n 회원님의 지인에게 보다 쉽게 문서를 공유하고\n 협업 할 수 있습니다. \n\nPolaris Office에 저장된 주소록은\n 암호화되어 안전하게 보관되며,\n 본 서비스 내 사용 목적 이외에는\n 다른 용도로 활용되지 않습니다.	将把您设备上的联系人电子邮箱列表上传到 Polaris Office 服务器。\n\n登录 Polaris Office 服务，可通过已上传的通讯录信息随时随地向您的联系人共享文件，并进行协作办公。\n\n保存在 Polaris Office 的通讯录会被加密，除本服务之外，不会用于其他用途。
PopContactNotice:title	Notification	주소록 수집 안내	通讯录收集向导
PopContactNotice:cancel	Cancel	취소	取消
PopContactNotice:btnMore	[More]	더 알아보기	了解更多
PopContactNotice:btnNext	Next step >	다음 단계	下一个阶段
			
PopFileDelete:lblText	Do you want to delete the selected file(s)?	선택한 파일(들)을 삭제하시겠습니까?	要删除选中的文件吗？
PopFileDelete:lblText2	Do you want to delete the item?	항목을 삭제하시겠습니까?	要删除项目吗？
PopFileDelete:lblFolder	Folder	폴더	文件夹
PopFileDelete:lblFile	File	파일	文件
PopFileDelete:btnDel	Delete (%d)	삭제 (%d)	删除 (%d)
			
PopNewFile:cellDoc	Word	워드	文档
PopNewFile:cellSheet	Sheet	시트	电子表格
PopNewFile:cellSlide	Slide	슬라이드	幻灯片
PopNewFile:cellText	Text	텍스트	文本文档
PopNewFile:cellNewFolder	Folder	폴더	新建文件夹
PopNewFile:cellHwp	Korean	한글	Hangul 文档
			
PopAlert:btnConfirm	OK	확인	确认
PopAlert:btnCancel	Cancel	취소	取消
PopAlert:btnPremium	Check Upgrades	업그레이드 서비스 확인	确认升级服务
PopAlert:btnYes	Yes	예	是
PopAlert:btnNo	No	아니오	不是
			
PopPremium:lblTitle	Polaris Office	Polaris Office	Polaris Office
PopPremium:lblText.newDoc	Upgrade your application for more features.	편집을 위해 업그레이드를 해 보세요.	升级后可以使用编辑功能。
PopPremium:lblText.saveDoc	Documents cannot be saved\nin the free trial version.	무료 서비스에서는 문서 저장 기능을\n사용하실 수 없습니다.	在免费服务中，不能使用文件保存功能！
PopPremium:btnShowAgain	Do now show this again	다시 보지 않기	不再提示
PopPremium:btnPremium	Check Upgrade\nService	프리미엄\n서비스 확인	确认付费服务
PopPremium:btnConfirm	OK	확인	确认
			
PopAddCloud:btnCancel	Cancel	취소	取消
PopAddCloud:lblCloudTitle	Cloud	클라우드	云盘
PopAddCloud:cellGoogle	Google Drive	Google Drive	Google Drive
PopAddCloud:cellBoxnet	Box.net	Box.net	Box.net
PopAddCloud:cellDropbox	Dropbox	Dropbox	Dropbox
PopAddCloud:cellWebDAV	WebDAV	WebDAV	WebDAV
PopAddCloud:cellSugarSync	Sugar Sync	Sugar Sync	Sugar Sync
PopAddCloud:cellUcloud	ucloud	ucloud	ucloud
PopAddCloud:cellSkyDrive	OneDrive	OneDrive	OneDrive
PopAddCloud:cellHuddle	Huddle	Huddle	Huddle
PopAddCloud:cellDocomo	Docomo	Docomo	Docomo
PopAddCloud:Unknown	Unknown	Unknown	未知
PopAddCloud:lblServiceTitle	Add Service	서비스 추가	添加服务
PopAddCloud:lblService	Service	서비스	服务
PopAddCloud:lblEmail	E-mail	이메일	电子邮箱
PopAddCloud:lblAccount	Account	계정	用户名
PopAddCloud:lblServiceWebDAV	Server Address	서버 주소	服务器地址
PopAddCloud:lblEmailWebDAV	Username	사용자 명	用户名称
PopAddCloud:lblPassword	Password	비밀번호	密码
PopAddCloud:btnConfirm	Done	완료	完成
PopAddCloud:btnBack	Back	이전	返回
PopAddCloud:fieldService	Required	필요함	必填
PopAddCloud:fieldEmail	Example@mail.com	Example@mail.com	Example@mail.com
PopAddCloud:fieldPassword	Required	필요함	必填
PopAddCloud:fieldEmailWebDAV	Options	옵션	可选
PopAddCloud:fieldPasswordWebDAV	Options	옵션	可选
PopAddCloud:alertNetworkDisconnected	You are not connected to a network. Please check your internet \n connection or Wi-Fi setting.	네트워크 연결이 꺼져 있습니다.\n셀룰러 데이터 또는 Wi-Fi 연결 후\n사용해 주세요.	网络连接已断开！请在连接蜂窝移动数据或 Wi-Fi 后使用。
PopAddCloud:alertNetworkError	You are not connected to a network. Please connect to a network or Wi-Fi first.	네트워크 연결이 꺼져 있습니다.\n셀룰러 데이터 또는 Wi-Fi 연결 후\n사용해 주세요.	网络连接已断开！请在连接蜂窝移动数据或 Wi-Fi 后使用。
PopAddCloud:alertNotAddress	Incorrect server address.	잘못된 서버주소입니다.	服务器地址错误！
PopAddCloud:alertAuthenticationError	The e-mail address/password \n you entered is not valid.\n Please enter again.	유효하지 않은 이메일 또는\n비밀번호입니다. 다시 시도해 주세요.	无效的邮箱地址或密码！请重试。
PopAddCloud:alertWebDAVAuthError	The e-mail address/password \n you entered is not valid.\n Please enter again.	유효하지 않은 사용자 명 또는\n비밀번호입니다. 다시 시도해 주세요.	无效的用户名或密码！\n请重试。
PopAddCloud:alertLoginExpiredError	The login session has expired.\nPlease log in again.	로그인 세션이 만료되었습니다.\n다시 로그인해 주세요.	登录会话已过期！\n请重新登录。
PopAddCloud:alertAuthenticationErrorTitle			
PopAddCloud:alertDupleTitle	This account is already in Use	계정 중복	账户重复
PopAddCloud:Error_AIRPLANE	Please turn off the Airplane mode to access the data.	데이터에 접근하려면, \n에어플레인 모드를 해제해 주세요.	要访问数据，请先解除飞行模式。
PopAddCloud:Error_ONZIP	Zip file error.	압축 파일 오류	压缩文件错误！
PopAddCloud:alertNotAddress	Wrong server address.	잘못된 서버 주소입니다.	服务器地址错误！
PopAddCloud:alertNotFindAddress	A server with the specified host name could not be found.	지정된 호스트 이름을 포함하는\n서버를 찾을 수 없습니다.	无法找到指定主机名的服务器！
PopAddCloud:DuplicateService	The service cannot be registered more than once.	해당서비스는 중복하여\n등록할 수 없습니다.	不能重复登录该服务！
PopAddCloud:WrongRequest	Server response error (%d).	서버 응답 오류(%d)	服务器响应错误 (%d)
			
PopInsertLabel:btnCancel	Cancel	취소	取消
PopInsertLabel:btnOk	OK	확인	确认
PopInsertLabel:lblTitle	Title	제목	标题
PopInsertLabel:xname	X Axis	X 축	水平轴
PopInsertLabel:yname	Y Axis	Y 축	垂直轴
PopInsertLabel:alertTitleLength	Titles cannot exceed 31 characters.	제목은 31자를 넘을 수 없습니다.	标题长度不能超过 31 个字符！
PopInsertLabel:alertLabelLength	Labels cannot exceed 31 characters.	레이블은 31자를 넘을 수 없습니다.	标签长度不能超过 31 个字符！
PopInsertLabel:alertXAxisLabelLength	X axis cannot exceed 31 characters.	X축 레이블은 31자를 넘을 수 없습니다.	水平轴标签长度不能超过 31 个字符！
PopInsertLabel:alertYAxisLabelLength	Y axis cannot exceed 31 characters.	Y축 레이블은 31자를 넘을 수 없습니다.	垂直轴标签长度不能超过 31 个字符！
			
PopTwoBtn:lblTitle	Delete	삭제	删除
PopTwoBtn:lblText	Do you want to delete\nthe %@ service?	해당 서비스(%@)를 \n삭제하시겠습니까?	要删除该服务 (%@) 吗？
PopTwoBtn:btnCancel	Cancel	취소	取消
PopTwoBtn:btnConfirm	OK	확인	确认
PopTwoBtn:btnOverwrite	Overwrite	덮어쓰기	覆盖
PopTwoBtn:lblContent	Do you want to delete all drawn objects in the current document?	문서 안에 포함된 드로잉을\n모두 지우시겠습니까?	要删除文件内的所有手绘对象吗？
PopTwoBtn:lblDeleteCurpage	Do you want to delete all drawn objects in the current page?	현재 페이지에 포함된 드로잉을 모두 지우시겠습니까?	要删除当前页面内的手绘对象吗？
PopTwoBtn:lblObject	Do you want to delete all the objects?	객체를 전체 지움 하시겠습니까?	要删除全部对象吗？
PopTwoBtn:lblModifiedObject	Do you want to delete all objects,\nincluding previously inserted objects?	이전에 입력한 객체를 포함하여\n현재 입력한 객체를 전체삭제\n하시겠습니까?	要删除全部对象 (包括以前输入的对象) 吗？
PopTwoBtn:lblAlreadyExist	%@'\nalready exists.	%@'\n이/가 존재합니다.	\%@\"\n已存在！"
PopTwoBtn:lblDeleteInk	Do you also want to save \n the pen annotations?	잉크 주석을 유지하시겠습니까?	要保留墨迹注释吗？
PopTwoBtn:lblChangeDoc	Some changes were made to this document.\nDo you want to save it?	문서를 교체하였습니다.\n저장하시겠습니까?	文件已被替换！\n要保存吗？
PopTwoBtn:lblSaveDoc	Do you want to save the document?	문서를 저장하시겠습니까?	要保存文件吗？
PopTwoBtn:lblSaveInk	Pen annotations history dectected.\nDo you want to save pen annotations?	잉크 주석 사용 내역이 있습니다.\n저장 하시겠습니까?	有墨迹注释内容！\n要保存吗？
PopTwoBtn:lblRetry	Do you want to retry?	재시도 하시겠습니까?	要重试吗？
PopTwoBtn:btnRetry	Retry	재시도	重试
PopTwoBtn:btnClose	Close	종료	结束
PopTwoBtn:btnYes	Yes	예	是
PopTwoBtn:btnNo	No	아니오	不是
PopTwoBtn:btnNoShow	Do not show this again	다시보지 않기	不再提示
PopTwoBtn:btnOK	OK	확인	确认
PopTwoBtn:noLookAgain	Do not show again	다시 보지 않기	不再提示
PopTwoBtn:btnPremium	Upgrade Account	계정 업그레이드	升级账户
			
PopShareMsg:ShareCurrentGroup	Share to the current group	현재 그룹에 공유	共享给当前群组
PopShareMsg:ShareOtherGroup	Share to the other group	다른 그룹에 공유	共享给其他群组
PopShareMsg:CancelShare	Cancel sharing	공유 취소	取消共享
			
PopEncoding:allExtract	Extract All	전체 압축해제	全部解压
			
PopEditCloud:fieldPassword	Required	필요함	必填
PopEditCloud:lblTitle	Edit Account	계정 편집	编辑账户
PopEditCloud:lblTitleWebDAV	Edit WebDAV	WebDAV 편집	编辑 WebDAV
PopEditCloud:lblService	Service	서비스	服务
PopEditCloud:lblServiceWebDAV	Server Address	서버 주소	服务器地址
PopEditCloud:lblEmail	E-mail	이메일	电子邮箱
PopEditCloud:lblEmailWebDAV	User Name	사용자 명	用户名称
PopEditCloud:lblPassword	Password	비밀번호	密码
PopEditCloud:btnConfirm	OK	확인	确认
PopEditCloud:btnBack	Back	이전	返回
PopEditCloud:alertAuthenticationError	The password does not match. Please enter it again.	비밀번호가 일치하지 않습니다.\n 다시 시도해 주세요.	密码不一致！请重试。
PopEditCloud:alertWebDAVAuthError	The password does not match. Please enter it again.	비밀번호가 일치하지 않습니다.\n 다시 시도해 주세요.	密码不一致！请重试。
PopEditCloud:alertNetworkError	Please check your network status,\nand then try it again.	네트워크 확인 후 다시 시도해 주세요.	请确认网络状态后重试。
PopEditCloud:alertNotAddress	Incorrect server address.	잘못된 서버주소입니다.	服务器地址错误！
PopEditCloud:alertNotFindAddress	Unable to find a server with the specified host name.	지정된 호스트 이름을 포함하는 \n서버를 찾을 수 없습니다.	无法找到包含指定主机名的服务器！
PopEditCloud:alertNetworkDisconnected	You are not connected to a network. \n Please connect to a network or Wi-Fi first.	네트워크 연결이 꺼져 있습니다.\n셀룰러 데이터 또는 Wi-Fi 연결 후\n사용해 주세요.	网络连接已断开！\n请在连接蜂窝移动数据或 Wi-Fi 后使用。
PopEditCloud:Error_AIRPLANE	To access the data,\nplease turn off Airplane mode.	데이터에 접근하려면, \n에어플레인 모드를 해제해 주세요.	如需访问网络数据，请关闭飞行模式。
			
PopMore:Save	Save	저장	保存
PopMore:SaveAs	Save As	다른 이름으로 저장	另存为
PopMore:Arrange	Rearrange Text	텍스트 재정렬	重排文本
PopMore:Find	Find	찾기	查找
PopMore:Memo	Show comments	메모 표시	显示批注
PopMore:Capture	Clip Document	문서 클리핑	文件剪裁
PopMore:Share	Share Document	문서 공유	共享文件
PopMore:Spell	Spelling Check	맞춤법 검사	拼写检查
PopMore:Toc	View Table of Contents	목차 보기	查看目录
PopMore:Remark	Show Annotations	주석 표기	显示注释
PopMore:RemarkList	Show Annotation List	주석 목록 보기	查看注释目录
PopMore:Replace	Find/Replace	찾기/바꾸기	查找/替换
PopMore:Layout	Page Layout	페이지 레이아웃	页面布局
PopMore:Recalc	Recalculate	재계산	重新计算
PopMore:Sort	Sort	정렬	排序
PopMore:slideNote	Slide Note	슬라이드 노트	幻灯片备注
PopMore:Filter	Filters	필터	筛选
PopMore:SmartGuide	Show Smart Guideline	스마트 안내선 표시	显示智能向导线
PopMore:FreezeFrame	Pin Frame	틀 고정	冻结
PopMore:UnfreezeFrame	Unpin Frame	틀 고정 해제	取消冻结
PopMore:EditMode	Switch to Edit Mode	편집 모드 전환	转到编辑模式
PopMore:ViewMode	Switch to Review Mode	검토 모드 전환	转到审阅模式
PopMore:Ruler	Ruler	눈금자	标尺
PopMore:SinglePage	View Each Page	페이지별 보기	单页视图
PopMore:Print	Print	인쇄	打印
PopMore:OpenIn	Open In	다음에서 열기... 	在其他应用中打开……
PopMore:linkcopy	Copy Link	링크 복사	复制链接
PopMore:SendFile	Send File	파일 보내기	发送文件
PopMore:ShareDoc	Share	공유	共享
PopMore:Link	Link	링크	链接
PopMore:AutoSave	Auto Recovery	자동 복구	自动恢复
			
PopTaskLog:logSection	Log	로그	日志
PopTaskLog:textFieldBase	Enter text.	텍스트를 입력해 주세요.	请输入文本
PopTaskLog:textFieldOffline	Please connect to a network first.	네트워크 연결 후 사용해 주세요.	请先连接网络后再使用
PopTaskLog:maxLength	Character limit has been exceeded.	제한된 글자수를 초과하였습니다.	已超过限制的字符数！
PopTaskLog:NetworkError	The network is busy.	네트워크 상태가 원활하지 않습니다.	网络状态不稳定！
			
PopSlideShow:btnFromFirst	From Beginning	처음부터	重头开始
PopSlideShow:btnFromCurrent	From Current Slide	현재 슬라이드부터	重当前幻灯片开始
			
PopBack:btnSave	Save	저장	保存
PopBack:btnSaveAs	Save As	다른 이름으로 저장	另存为
PopBack:btnCancel	Do Not Save	저장하지 않음	不保存
PopBack:btnCancel1	Cancel	취소	取消
PopBack:lblInk1	Do you want to retain the pen annotations	잉크 주석을 유지하여	保留墨迹注释
PopBack:lblInk2	and save?	저장하시겠습니까?	要保存吗？
			
PopSend:lblTitle	Send	보내기	发送
PopSend:FileSend	Send Document	문서 보내기	发送文件
PopSend:SendLink	Send Download Link	이메일로 링크 보내기	通过电子邮件发送链接
PopSend:Print	Print	인쇄	打印
PopSend:OpenIn	Open in the Following...?	다음에서 열기...	在其他应用中打开……
			
PopSortList:btnName	Name	이름순	名称
PopSortList:btnDate	Date	날짜순	日期
PopSortList:btnType	Type	형식순	类型
			
PopShareSort:btnGroup	Group	그룹순	组合
PopShareSort:btnDate	Date	날짜순	日期
			
PopSortServiceList:item_date	Date	날짜순	日期
PopSortServiceList:item_type	Type	형식순	类型
			
PopPDFDraw:highlight	Highlight	하이라이트	高亮
PopPDFDraw:underLine	Underline	밑줄	下划线
PopPDFDraw:cancelLine	Strikethrough	취소선	删除线
PopPDFDraw:circle	Circle	원형	圆形
PopPDFDraw:rectangle	Rectangle	사각형	四边形
PopPDFDraw:arrow	Arrow	화살표	箭头
PopPDFDraw:line	Line	선	线条
			
PopHyperlink:lblEditHyperlink	Edit hyperlink	하이퍼링크 편집	编辑超链接
PopHyperlink:lblHyperlink	Add Hyperlink	하이퍼링크 추가	添加超链接
PopHyperlink:hyperlinkOk	OK	확인	确认
PopHyperlink:hyperlinkCancel	Cancel	취소	取消
PopHyperlink:textFieldPlaceholder	Title	제목	标题
			
PopCellDelete:lblTitle	Delete Cells	셀 삭제	删除单元格
PopCellDelete:lblLeft	Shift cells left	셀을 왼쪽으로 밀기	单元格左移
PopCellDelete:lblUp	Shift cells up	셀을 위로 밀기	单元格上移
PopCellDelete:lblRow	Entire row	행 전체 삭제	删除整行
PopCellDelete:lblCol	Entire column	열 전체 삭제	删除整列
			
PopCellClear:lblTitle	Clear	지우기	清除
PopCellClear:lblAll	Clear all	모두 지우기	清除全部
PopCellClear:lblText	Clear text	내용 지우기	清除内容
PopCellClear:lblForm	Clear form	서식 지우기	清除格式
			
PopFind:lblMatchCase	Match case	대소문자 구분	区分大小写
PopFind:lblWordOnly	Find whole words only	단어 단위로 찾기	全字匹配
			
PopFx:lblTitle	Functions	함수	函数
PopFx:All	View All	모두 보기	查看全部
PopFx:Recent	Recent Items	최근 항목	最近使用的函数
PopFx:Finalcial	Finance	재무	财务
PopFx:Math	Math	수학	数学
PopFx:Date/Time	Date/Time	날짜/시간	日期/时间
PopFx:Statistical	Statistics	통계	统计
PopFx:Lookup	Lookup/Reference Functions	찾기/참조 영역	查找/引用
PopFx:Database	Database	데이터베이스	数据库
PopFx:Text	Text	텍스트	文本
PopFx:Logical	Logic	논리	逻辑
PopFx:Info	Information	정보	信息
PopFx:btnBack	Back	이전	返回
PopFx:btnFx	Functions	함수	函数
PopFx:SUM	Sum	합계	求和
PopFx:AVERAGE	Average	평균	平均
PopFx:COUNT	Number Count	숫자 개수	计数
PopFx:MAX	Maximum Value	최대값	最大值
PopFx:MIN	Minimum Value	최소값	最小值
PopFx:lblSubTitleAutoFx	Automatic Calculation	자동연산	自动计算
PopFx:lblSubTitleFx	Functions	함수	函数
			
PopFxAuto:SUM	Sum	합계	求和
PopFxAuto:AVERAGE	Average	평균	平均
PopFxAuto:COUNT	Number Count	숫자 개수	计数
PopFxAuto:MAX	Maximum Value	최대값	最大值
PopFxAuto:MIN	Minimum Value	최소값	最小值
			
PopFxSub:tfSearch	Search Functions	함수 검색	搜索函数
PopFxSub:lblEmpty	No search results.	검색 결과 없음	没有搜索结果
			
PopFilter:noneValue	No available field value.	필드 값 없음	空白
			
PopCellMerge:lblTitle	Merge Cells	셀 병합	合并单元格
PopCellMerge:lblText	If you merge these cells, only the data\ni n the left column will remain.\nDo you want to continue?\n	셀을 병합하면 가장 윗 행의 왼쪽\n데이터만 남습니다.\n계속 진행하시겠습니까?\n	合并单元格时，只保留第一行左侧单元格数据。\n要继续吗？
PopCellMerge:btnNo	No	아니오	不是
PopCellMerge:btnYes	Yes	예	是
			
PopDeleteMemo:lblText	Do you want to delete this comment?	현재 보고 있는 메모를 지우시겠습니까?	你是否要删除此评论吗？
PopDeleteMemo:btnCancel	Cancel	취소	取消
PopDeleteMemo:btnConfirm	OK	확인	确认
PopDeleteMemo:btnNo	No	아니오	不是
PopDeleteMemo:btnYes	Yes	예	是
			
PopProgress:operationStr	(%d/%d)	(%d/%d)	(%d/%d)
PopProgress:overwriteStr	\nThe file already exists. Do you want to overwrite it?	\n동일한 파일이 존재합니다. 기존 파일을\n현재 파일로 덮어쓰시겠습니까?	已有相同文件！\n要用当前文件覆盖原文件吗？
PopProgress:zeroSize	The file size is 0. It cannot be uploaded.	크기가 0인 파일은 업로드할 수 없습니다.	不能上传大小为 0 的文件！
PopProgress:completed	%@ is completed.	%@ 완료	%@完成
PopProgress:btnOk	OK	확인	确认
PopProgress:btnCancel	Cancel	취소	取消
PopProgress:btnNo	No	아니오	不是
PopProgress:btnYes	Yes	예	是
PopProgress:reservationStop	Sharing will be canceled.	취소가 예약되었습니다.	已预约取消
PopProgress:sharedDocOverwrite	(*Documents are no longer shared.)	(* 공유 문서는 공유가 끊어집니다.)	(* 将断开文件共享)
PopProgress:notCancel	You can not cancel the download.	다운로드를 취소 할 수 없습니다.	不能取消下载！
			
PopPenSetting:lblTitle	Pen Settings	펜 설정	墨笔设置
PopPenSetting:lblTitle1	Settings	설정	设置
			
PopSpinKeypad:btnConfirm	OK	확인	确认
PopSpinKeypad:toastOutsideRange	Enter a value between %d-%d.	%d ~ %d 사이의 값을 입력해 주세요.	请输入 %d ~ %d 之间的值
PopSpinKeypad:toastOutsideRangeWithDot	Enter a value between %.1f-%.1f.	%.1f ~ %.1f 사이의 값을 입력해 주세요.	请输入 %.1f ~ %.1f 之间的值
			
PopUpDownload:btnUpload	Upload	업로드	上传
PopUpDownload:btnDownload	Download	다운로드	下载
			
PopPassword:lblTitle	Document Password	문서암호	文件密码
PopPassword:btnCancel	Cancel	취소	取消
PopPassword:btnConfirm	OK	확인	确认
PopPassword:lblPassword	The file is password-protected. Please enter the password to edit.	열기 암호로 보호된 파일입니다. 암호를 입력해 주세요.	该文件受密码保护，请输入密码。
PopPassword:lblPasswordDiff	The password does not match.\nPlease try again.?	비밀번호가 일치하지 않습니다.\n다시 시도해 주세요. 	密码不一致！\n请重试。
PopPassword:tfdPasswordHint	Enter Password	비밀번호 입력	输入密码
			
PopLoading:lblLoading	Loading...	로딩 중	正在加载
PopLoading:lblSaving	Saving...	저장 중	正在保存
PopLoading:lblSync	Synchronization started...	초기 동기화 중...	正在进行首次同步……
PopLoading:lblAutoSaving	Creating the auto-recovered file...	자동 복구 파일 생성 중...	正在创建自动修复文件……
PopLoading:lblWating	Please wait.	잠시만 기다려 주세요.	请稍等
PopLoading:lblAddressSync	Synchronizing the address books...	주소록 동기화 중	正在同步通讯录
PopLoading:lblFinding	Searching...	찾는 중	正在查找
PopLoading:lblReplacing	Replacing...	바꾸기 중	正在替换
PopLoading:lblDeleting	Deleting...	삭제 중...	正在删除……
PopLoading:lblUpdateInfo	Updating Info...	정보를 업데이트 중입니다.	正在上传信息
			
PopListLoading:btnCancel	Cancel	취소	取消
PopListLoading:connect	Loading...	로딩 중...	正在加载……
			
FNGuestListCell:deleteBtn	Delete	삭제	删除
			
EDocController:propertyNone	Select an object and press it again.	속성 편집을 지원하지 않는 객체입니다.	请选择文本或对象后重试
EDocController:NOT_SUPPORT_PROPERTY	This object cannot be edited	텍스트나 객체를 선택한 후에 다시 눌러 주세요.	当前对象不支持编辑属性
EDocController:lblModeEdit	Edit Mode	편집 모드	编辑模式
EDocController:lblModeView	Review Mode	검토 모드	审阅模式
EDocController:enableMultiSelect	You can select multiple objects.	다중 객체를 선택할 수 있습니다.	可选择多个对象
EDocController:disableMultiSelect	You disabled multi-selection mode.	다중 객체 선택 모드가 해제되었습니다.	已退出多重对象选择模式
EDocController:terminate	Information	안내	介绍
EDocController:INTERNAL_ERROR	Invalid file.	유효하지 않은 파일입니다.	无效的文件！
EDocController:MEMORY_ERROR	Not enough memory.	메모리가 부족합니다.	内存不足！
EDocController:UNSUPPORTED_TYPE	This file format is not supported.	지원되지 않는 파일입니다.	不支持的文件格式！
EDocController:DOC_EDIT_PROTECT	This document is protected. It will open in Read-only mode.	보호된 문서입니다. 읽기전용으로 열립니다.	已设置保护的文件，会以只读模式打开。
EDocController:UNSUPPORTED_ENCRYPTION_TYPE	This file format is not supported due to encryption.	지원되지 않는 암호화 파일입니다.	不支持的加密文件！
EDocController:DOCUMENT_TRUNCATED	Unable to open the file.	파일을 열 수 없습니다.	无法打开文件！
EDocController:DOC_WRITE_PASSWORD	This file is write-protected.\nAll editing features are disabled.	쓰기 암호로 보호된 파일입니다.	以写入密码受保护的文件
EDocController:DOC_PROTECT	Protected documents cannot\nbe edited.	보호 문서는 편집을 지원하지 않습니다.	不支持编辑被保护的文件
EDocController:DOC_PASSWORD_FILE	Password protected documents\ncannot be edited.	암호가 설정된 문서는 편집을\n 지원하지 않습니다.	不支持编辑已设置密码的文件
EDocController:DOC_PASSWORD_FILE_LINK”	“Pen annotations will not be saved in password-protected documents.	암호문서는 슬라이드 쇼의 잉크를 저장하지 않습니다.	(*)Password-protected documents cannot save the ink.
EDocController:toastChartEditString1	Tap the chart twice	차트를 이중 탭 하면 데이터를	双击图表时
EDocController:toastChartEditString2	Edit	편집할 수 있습니다.	可以编辑数据
EDocController:noRecommend	No suggested word	추천 단어가 없습니다.	没有推荐的单词
EDocController:sendFileSave	Modified document will be saved. \nDo you want to continue?	작성 중인 문서가 자동 저장됩니다.\n계속 진행하시겠습니까?	正在编辑中的文件会被自动保存，\n继续吗？
EDocController:sendFileOk	Save	저장	保存
EDocController:sendFileCancel	Cancel	취소	取消
EDocController:spellCheck	Spell check is only supported in English.	맞춤법 검사는 영어만 지원합니다.	只支持对英语的拼写检查
EDocController:recovery	Recovered	복구됨	已修复！
EDocController:recoveryPath	Recover	복구	修复
EDocController:SavePDF	Saved as a PDF file.	PDF로 저장되었습니다.	已保存为 PDF 文档
EDocController:2003freedrawNotsupport	Drawn objects cannot be saved in MS Office 2003 documents.	2003 문서의 경우 그리기를 저장 할 수 없습니다.	对 2003 格式文件，无法保存手绘对象。
EDocController:toastNotSupport3D	This shape is not applicable for 3D rotation.	3차원 회전을 적용할 수 없는 도형입니다.	该形状无法使用三维旋转！
EDocController:sendError	The server is not responding. \nPlease try it again later.	서버로부터 응답이 없습니다. \n잠시 후 다시 시도해 주세요.	服务器没有响应！请稍后重试。
EDocController:autoSavingDelayTitle	Creating the auto-recovered file...	자동 복구 파일 생성 중...	正在创建自动修复文件……
EDocController:autoSavingDelay	There is a delay in creating the file.\nPlease wait.	파일 생성이 지연되고 있습니다.\n잠시만 기다려주시기 바랍니다.	创建文件被延迟！\n请稍等。
EDocController:presentOpenIn	There is no application is available for use.	사용할 수 있는 애플리케이션이 없습니다.	没有可用的应用程序！
EDocController:ToastOpenInError	There are some contents being edited.\nPlease save first and try it again.	편집 중인 내용이 있습니다.\n문서를 저장한 뒤 다시 시도해 주세요.	正在编辑文档，请保存后重试！
EDocController:lastPage	The slide show ended.\nTo exit, please tap the screen twice.	슬라이드 쇼가 끝났습니다.\n 끝내려면 더블 탭 해 주세요.	幻灯片放映已结束！\n请双击屏幕退出。
EDocController:popChangeDoc	Do you want to switch to the file that contains pen annotations?\nThese annotations will be deleted if you do not save it separately.	잉크 주석이 저장된 문서로 교체하시겠습니까?\n문서 교체 없이 저장 시 잉크 주석이 사라집니다.	要用已保存墨迹注释的文件替换吗？\n不替换文件的情况下保存时，墨迹注释会被丢失。
EDocController:CannotInsertImage	(number) vertical mode cannot contain the image.	가로모드에서 이미지를 삽입할 수 없습니다.	在横屏模式下无法插入图片！
EDocController:CannotInsertVideo	(number) vertical mode cannot contain the video.	가로모드에서 동영상을 삽입할 수 없습니다.	在横屏模式下无法插入视频！
EDocController:unableInsertChartOfAreaType	2 or more areas of the same type\nare required for surface charts.	표면형 차트에는 계열이 2개 이상\n필요합니다.	曲面图需要 2 个以上系列。
EDocController:StorageNotEnough	Not enough memory. Please delete some files and try again.	단말 저장 공간이 부족합니다.\n저장 공간을 확보한 후\n다시 시도해 주세요.	存储空间不足！\n请获得更多空间后重试。
EDocController:FailedSave	Failed to save.	저장 실패	保存失败！
EDocController:FailedToSave	Failed to save.\nPlease try it again.	저장에 실패하였습니다.\n다시 시도해 주세요.	保存失败！\n请重试。
EDocController:DocumentIsTruncated	This document contains an error.	문서에 오류가 있습니다.	文件有错误！
EDocController:FileCreateFail	Failed to create a file.	파일 생성에 실패하였습니다.	新建文件失败！
EDocController:FileWriteFail	Failed to write a file.	파일 쓰기에 실패하였습니다.	文件写入失败！
EDocController:FailedToPDFExport	Failed to export the data to PDF. Please try it again.	PDF 내보내기에 실패하였습니다. 다시 시도해 주세요.	PDF 转换失败！请重试。
EDocController:ErrorOccurred	An error has occurred.	오류가 발생하였습니다.	发生错误！
EDocController:CannotFindVideo	Video file not found.	동영상 파일을 찾을 수 없습니다.	无法找到视频文件！
EDocController:CannotSupportVideo	This video format is not supported.	지원하지 않는 동영상 파일입니다.	不支持的视频文件！
EDocController:toastLimitMultiSelect	You can only select up to 10 objects.	객체는 한 번에 10개까지 선택할 수 있습니다.	可同时选择 10 个对象。
EDocController:errorNonConnectWiFi	You are not connected to a Wi-Fi network.\nPlease check your Wi-Fi connection.	Wi-Fi가 연결되지 않았습니다.\nWi-Fi 연결 상태를 확인해 주세요.	未连接 Wi-Fi！\n请确认 Wi-Fi 连接状态。
EDocController:Alert_NetworkDisconnected	Your network connection is disabled.\nPlease check your internet connection or Wi-Fi setting.	네트워크 연결이 꺼져 있습니다.\n셀룰러 데이터 또는 Wi-Fi 연결 후\n사용해 주세요.	网络连接已断开！\n请在连接蜂窝移动数据或 Wi-Fi 后使用。
EDocController:Error_AIRPLANE	Please turn off airplane mode to access data.	데이터에 접근하려면, \n에어플레인 모드를 해제해 주세요.	要访问数据，请先解除飞行模式。
EDocController:copyToClipboard	Copy to clipboard.	클립보드에 복사되었습니다.	已复制到剪贴板！
EDocController:btnSrcMenu2	Share	공유	共享
EDocController:btnSrcMenu3	Log	로그	日志
EDocController:btnSrcMenu4	Log (x)	로그 (x)	日志 (x)
EDocController:failedCreateWeblink	URL link cannot be created. Please check your network and try it again.	링크를 생성할 수 없습니다.\n네트워크 연결 후 다시 시도해주세요.	无法创建链接，请连接网络后重试。
EDocController:sendWeblinkMailTitle	%@' document has been shared.	%@' 문서의 링크를 공유하였습니다.	共享了\%@\"文件链接"
EDocController:sendWeblinkMailBody	%@<%@> has shared '%@' document's link.\n\n%@\n\n\You can edit and share documents anytime and anywhere in Polaris Office.\""	%@<%@>님이 '%@' 문서의 링크를 공유하였습니다.\n\n%@\n\nPolaris Office를 통해 문서를 기반으로 동료와 커뮤니케이션하고 언제 어디서나 연속적인 문서 작업을 할 수 있습니다.	%@<%@>共享了\%@\"文件链接。\n\n%@\n\nPolaris Office 是基于文件与同事进行沟通，并随时随地可连续处理文件的云办公服务。"
EDocController:sendWeblinkFacebook	Document has been shared in Polaris Office.	Polaris Office에서 문서를 공유하였습니다.	在 Polaris Office 共享了文件
EDocController:sendWeblinkTwitter	Document has been shared in Polaris Office.\n%@ %@	Polaris Office에서 문서를 공유하였습니다.\n%@ %@	在 Polaris Office 共享了文件\n%@ %@
EDocController:SNSNameTwitter	Twitter	트위터	Twitter
EDocController:SNSNameFacebook	Facebook	페이스북	Facebook
EDocController:SNSConfigureNeeded	Sign up with %@ account\nand try again.	%@ 계정 설정 후 다시 시도해주세요.	请设置%@账户后重试
EDocController:error116	You are not authorized to the access to this document.	해당 문서에 접근 권한이\n없습니다.	没有访问相应文件的权限
EDocController:share.kakao.msg	Document has been shared in Polaris Office.	Polaris Office에서 문서를 공유하였습니다.	在 Polaris Office 共享了文件
EDocController:share.line.msg	Document has been shared in Polaris Office.\n%@	Polaris Office에서 문서를 공유하였습니다.\n%@	在 Polaris Office 共享了文件\n%@
EDocController:popshare.description	Do you want to share '%@'	%@' 문서를 공유하시겠습니까?	您要共享 '%@' 文件吗？
			
ETextController:lblReplacing	Replacing...	바꾸기 중	正在替换
ETextController:msgReplaceAll	%d have been replaced.	%d개가 바뀌었습니다.	已有 %d 个被替换
			
EPageLayoutVC:lblTitle	Page Layout	페이지 레이아웃	页面布局
EPageLayoutVC:btnCancel	Cancel	취소	取消
EPageLayoutVC:btnDone	Done	완료	完成
EPageLayoutVC:btnBackToSetting	Back	이전	返回
EPageLayoutVC:btnOrigin	Default	기본값으로 설정	设为默认值
EPageLayoutVC:lblOrigin	Do you want to set Custom Margins as a default?	사용자 지정 여백을 기본값으로 변경하시겠습니까?	要把自定义页边距设为默认值吗？
EPageLayoutVC:lblMargin	Margins	여백	页边距
EPageLayoutVC:lblSize	Size	크기	大小
EPageLayoutVC:lblDirection	Direction	방향	方向
EPageLayoutVC:lblColumn	Columns	단	分栏
EPageLayoutVC:lblRange	Range	적용 범위	适用范围
EPageLayoutVC:lblCustom	Custom	사용자\n지정	用户\n自定义
EPageLayoutVC:lblCustomTitle	Custom Margins	사용자 지정 여백	自定义页边距
EPageLayoutVC:lblCustomTop	Top (cm)	위쪽 (cm)	上(cm)
EPageLayoutVC:lblCustomBottom	Bottom (cm)	아래쪽 (cm)	下(cm)
EPageLayoutVC:lblCustomLeft	Left (cm)	왼쪽 (cm)	左(cm)
EPageLayoutVC:lblCustomRight	Right (cm)	오른쪽 (cm)	右(cm)
EPageLayoutVC:segAfterThisLocation	Applied after current position	현재 위치 다음부터	当前位置之后
EPageLayoutVC:segAllPage	Whole document	문서 전체	所有页面
EPageLayoutVC:segThisArea	This area	이 구역	当前区域
			
EPageLayoutVCForPhone:lblPageLayout	Page Layout	페이지 레이아웃	页面布局
EPageLayoutVCForPhone:lblCustomTitle	Custom	사용자 지정	自定义
EPageLayoutVCForPhone:lblCustom	Custom	사용자\n지정	用户\n自定义
EPageLayoutVCForPhone:lblMargin	Margins	여백	页边距
EPageLayoutVCForPhone:lblSize	Size	크기	大小
EPageLayoutVCForPhone:lblDirection	Direction	방향	方向
EPageLayoutVCForPhone:lblParagraph	Paragraph	단	分栏
EPageLayoutVCForPhone:segAfterThisLocation	Applied after current position	현재 위치 다음부터	当前位置之后
EPageLayoutVCForPhone:segAllPage	Whole document	문서 전체	所有页面
EPageLayoutVCForPhone:segThisArea	This area	이 구역	当前区域
EPageLayoutVCForPhone:btnCancel	Cancel	취소	取消
EPageLayoutVCForPhone:btnBack	Page Layout	페이지 레이아웃	页面布局
EPageLayoutVCForPhone:btnDone	Done	완료	完成
EPageLayoutVCForPhone:btnOrigin	Default	기본값으로 설정	设为默认值
EPageLayoutVCForPhone:lblOrigin	Do you want to set Custom Margins as a default?	사용자 지정 여백을 기본값으로 변경하시겠습니까?	要把自定义页边距设为默认值吗？
EPageLayoutVCForPhone:lblMarginTop	Top (cm)	위쪽(cm)	上(cm)
EPageLayoutVCForPhone:lblMarginBottom	Bottom (cm)	아래쪽(cm)	下(cm)
EPageLayoutVCForPhone:lblMarginLeft	Left (cm)	왼쪽(cm)	左(cm)
EPageLayoutVCForPhone:lblMarginRight	Right (cm)	오른쪽(cm)	右(cm)
			
EWordMemoManager:hint	Write a comment	메모를 입력하세요.	请输入批注
			
EHeaderFooterVC:btnDone	Close	닫기	关闭
EHeaderFooterVC:headerTitle	Header	머리글	页眉
EHeaderFooterVC:footerTitle	Footer	바닥글	页脚
EHeaderFooterVC:lblColumn1Title	Blank	비어 있음	空白
EHeaderFooterVC:lblColumn3Title	Blank (3 Columns)	비어 있음(3열)	空白(三栏)
EHeaderFooterVC:templateColumn1	Enter text	텍스트 입력	输入文本
EHeaderFooterVC:templateColumn3_land	Enter text Enter text Enter text	텍스트 입력                           텍스트 입력                           텍스트 입력	输入文本                           输入文本                           输入文本
EHeaderFooterVC:templateColumn3_port	Enter text Enter text Enter text	텍스트 입력               텍스트 입력               텍스트 입력	输入文本               输入文本               输入文本
EHeaderFooterVC:lblPageNumTitle	Page Number	페이지 번호	页码
			
EHeaderFooterVCForPhone:btnDone	Close	닫기	关闭
EHeaderFooterVCForPhone:headerTitle	Header	머리글	页眉
EHeaderFooterVCForPhone:footerTitle	Footer	바닥글	页脚
EHeaderFooterVCForPhone:lblColumn1Title	Blank	비어 있음	空白
EHeaderFooterVCForPhone:lblColumn3Title	Blank (3 Columns)	비어 있음(3열)	空白(三栏)
EHeaderFooterVCForPhone:templateColumn1	Enter text	텍스트 입력	输入文本
EHeaderFooterVCForPhone:templateColumn3_land	Enter text Enter text Enter text	텍스트 입력                           텍스트 입력                           텍스트 입력	输入文本                           输入文本                           输入文本
EHeaderFooterVCForPhone:templateColumn3_port	Enter text Enter text Enter text	텍스트 입력               텍스트 입력               텍스트 입력	输入文本               输入文本               输入文本
EHeaderFooterVCForPhone:lblPageNumTitle	Page Number	페이지 번호	页码
			
EFindListManager:lblTitle	Search Results (%d)	검색 결과(%d)	搜索结果 (%d)
			
ESaveAs:btnCancel	Cancel	취소	取消
ESaveAs:btnOk	Save	저장	保存
ESaveAs:lblTitle	Save As	다른 이름으로 저장	另存为
ESaveAs:lblFilename	Filename	파일 이름	文件名
ESaveAs:lblPathTitle	Folder Path	폴더 경로	文件夹路径
ESaveAs:Invalid file name	Invalid name.	유효하지 않은 이름입니다	无效的文件名！
ESaveAs:lblIncludeDraw	Save including drawn objects	그리기 포함하여 저장	手绘对象也一同保存
ESaveAs:lblIncludeDrawContent	Drawn memos will not be shown on PC.	그리기 메모는 PC에서 보이지 않습니다.	在 PC 上不显示手绘批注
ESaveAs:NotUseSpecialCharacters	Special characters (/, :, *, ?, <, >, |, \, and \)\ncannot be used.	특수문자 (\\ / : * ? \ “ < > |)는\n사용할 수 없습니다.	不能使用特殊字符 (\\ / : * ? \ “ < > |)！
ESaveAs:maxLength	File/folder names cannot exceed %d characters.	파일/폴더 이름은 %d자를 넘어갈 수 없습니다.	文件名/文件夹名不能超过 %d 个字符！
ESaveAs:maxFilePathByte	Cannot exceed %d bytes.	전체 경로는 %d Byte를\n 넘어갈 수 없습니다.	全部路径不能超过 %d 字节！
ESaveAs:lblSavePdf	Save as a PDF	PDF로 내보내기	保存为 PDF
ESaveAs:wrongName	Cannot use the name of \%@\"."	\%@\"이름은\n사용할 수 없습니다."	不能使用\%@\"名称!"
			
FSettingAutoRestore:lblTitle	Set Auto Save	자동 저장 설정	设置自动保存
FSettingAutoRestore:btnOk	Close	닫기	关闭
FSettingAutoRestore:lblForceSave	Auto save	무조건 자동 저장	始终自动保存
FSettingAutoRestore:lblSleepSave	Auto save after edit	쉴 때 자동 저장	休眠时自动保存
FSettingAutoRestore:Min	Minutes	분	分
FSettingAutoRestore:Sec	Seconds	초	秒
			
ESort:btnCancel	Cancel	취소	取消
ESort:btnOk	Done	완료	完成
ESort:btnSort	Sort	정렬	排序
ESort:lblTitle	Sort	정렬	排序
ESort:lblFirst	First standard	첫째 기준	第一关键字
ESort:lblSecond	Second standard	둘째 기준	第二关键字
ESort:lblThird	Third standard	셋째 기준	第三关键字
ESort:lblDirection	Direction	방향	方向
ESort:lblUpDown	Top to bottom	위쪽에서 아래쪽으로	从上到下
ESort:lblLeftRight	Left to right	왼쪽에서 오른쪽으로	从左到右
ESort:lblSelect	Select	선택	选择
ESort:lblNothing	None	없음	无
			
EFigureSetter:btnCancel	Cancel	취소	取消
EFigureSetter:btnOk	Done	확인	完成
EFigureSetter:titleAll	Size and Rotation	크기 및 회전	大小和旋转
EFigureSetter:titleResize	Size	크기	大小
EFigureSetter:titleRotate	Rotate	회전	旋转
EFigureSetter:titleSplit	Split into different cells	셀 분할	拆分单元格
EFigureSetter:titleRow	Row Height	행 높이	行高
EFigureSetter:titleColumn	Column Width	열 너비	列宽
EFigureSetter:titleOptFormGreater	Emphasize top N cells	상위 N개의 셀 강조	突出显示前 N 个单元格
EFigureSetter:titleOptFormLess	Emphasize bottom N cells	하위 N개의 셀 강조	突出显示后 N 个单元格
EFigureSetter:titleOptFormGreaterPercentage	Emphasize top N% cells	상위 N%의 셀 강조	突出显示前 N% 的单元格
EFigureSetter:titleOptFormLessPercentage	Emphasize bottom N% cells	하위 N%의 셀 강조	突出显示后 N% 的单元格
EFigureSetter:titleOptFormBigger	Greater Than	보다 큼	大于
EFigureSetter:titleOptFormSmaller	Smaller Than	보다 작음	小于
EFigureSetter:titleOptFormEqual	Equal	같음	等于
EFigureSetter:titleOptFormDuple	Duplicate Value	중복 값	重复值
EFigureSetter:lblOptionBigger	Format cells containing values greater than the following	다음 값보다 큰 셀의 서식 지정	指定大于以下值的单元格格式
EFigureSetter:lblOptionSmaller	Format cells containing values smaller than the following	다음 값보다 작은 셀의 서식 지정	指定小于以下值的单元格格式
EFigureSetter:lblOptionSmaller	Format cells containing values equal to the following	다음 값과 같은 셀의 서식 지정	指定等于以下值的单元格格式
EFigureSetter:lblOptionGreater	Set format followed by greater cell	다음 상위 순위의 셀에 속하는 서식 지정	指定排名靠前的单元格格式
EFigureSetter:lblOptionLess	Set format followed by lesser cell	다음 하위 순위의 셀에 속하는 서식 지정	指定排名靠后的单元格格式
EFigureSetter:width	Width (mm)	너비 (mm)	宽度 (mm)
EFigureSetter:height	Height (mm)	높이 (mm)	高度 (mm)
EFigureSetter:row	Row	행	行
EFigureSetter:column	Column	열	列
EFigureSetter:lblRatio	Retain ratio	비율 유지	保持比例
EFigureSetter:lblRotate	Rotate (%@)	회전 (%@)	旋转 (%@)
EFigureSetter:toastRangeException	Enter a value between %.1f-%.1f.	%.1f ~ %.1f 사이의 값을 입력해 주세요.	请输入从 %.1f 至 %.1f 的值
EFigureSetter:toastRangeIntException	Enter a value between %d-%d.	%d ~ %d 사이의 값을 입력해 주세요.	请输入从 %d 至 %d 的值
EFigureSetter:toastRangeSplit	Enter a value between %d-%d.	%d ~ %d 사이의 값을 입력해 주세요.	请输入 %d 至 %d 的值
			
EInsertController:Image	Image	이미지	图片
EInsertController:Shape	Shape	도형	形状
EInsertController:Table	Table	표	表格
EInsertController:Chart	Chart	차트	图表
EInsertController:Cell	Cell	셀	单元格
			
EInsertTable:btnCreate	Create Chart	표 생성	创建表格
EInsertTable:Title	Enter	입력	输入
EInsertTable:lblInsertCol	Columns	열 개수	列数
EInsertTable:lblInsertRow	Rows	행 개수	行数
			
EInsertImage:Photo	Take a picture	사진촬영	照相
EInsertImage:Video	Capture Video	동영상촬영	拍摄视频
EInsertImage:Camera	Camera Roll	카메라 롤	相机胶卷
EInsertImage:videoAlbum	Video	동영상	视频
EInsertImage:lblTitle0	Picture	사진	照片
EInsertImage:lblTitle2	Choose Photo	사진 선택하기	选择照片
EInsertImage:btnBack	Back	이전	返回
EInsertImage:btnClose	Close	닫기	关闭
EInsertImage:btnConfirm	Confirm	확인	确认
EInsertImage:lblEmpty	Use the camera to take pictures and capture video.\nYou can synchronize pictures and video %@\nthrough iTunes.	카메라를 통해 사진 및 비디오를 찍거나,\n iTunes를 통해 사진 및 비디오를\n %@에 동기화할 수 있습니다.	可通过相机拍摄照片或视频，\n通过 iTunes 向 %@ 同步照片或视频。
			
EInsertShape:alarmCurve	Tap the screen to begin drawing a curve. \n Double-tap the drawing when complete.	화면에 탭을 하는 궤적을 따라 곡선이 그려집니다.\n더블 탭 하면 그리기가 완료됩니다.	按照屏幕上拖动的轨迹绘出曲线。\n双击完成手绘。
EInsertShape:freeMode	Tap the screen to begin drawing a line. \n Double-tap the drawing is complete	화면에 탭을 하는 궤적을 따라 연결된 직선이 그려집니다.\n더블 탭 하면 그리기가 완료됩니다.	按照屏幕上拖动的轨迹绘出直线。\n双击完成手绘。
EInsertShape:freeModePhone	Tap the screen to begin drawing a line. \n Double-tap the drawing is complete	화면에 탭을 하는 궤적을 따라 연결된 직선이\n그려집니다. 더블 탭 하면 그리기가 완료됩니다.	按照屏幕上拖动的轨迹绘出直线。\n双击完成手绘。
EInsertShape:freeLine	Tap and hold to draw freehand. \n Lift your finger to complete the drawing.	화면에 자유롭게 곡선을 그릴 수 있습니다.\n손을 떼면 그리기가 완료 됩니다.	可在屏幕上绘出自由曲线。\n释放屏幕时完成手绘。
			
EInsertCell:Right	Shift cells right	셀을 오른쪽으로 밀기	单元格右移
EInsertCell:Down	Shift cells down	셀을 아래로 밀기	单元格下移
EInsertCell:Row	Entire row	행 전체	整行
EInsertCell:Col	Entire column	열 전체	整列
			
ETitleBar:btnBack	Back	이전	返回
ETitleBar:btnSlide:LMode	Edit Mode	편집모드	编辑模式
ETitleBar:btnSlide:RMode	Review Mode	검토모드	审阅模式
			
ESlideChangeScreen:btnEffectAll	Apply to all slides	전체 슬라이드 적용	应用于全部幻灯片
ESlideChangeScreen:effectall	Apply to all slides	전체 슬라이드에 적용되었습니다.	应用于全部幻灯片
			
ESlideLayout:lblTitle	Layout	레이아웃	布局
ESlideLayout:btnClose	Close	닫기	关闭
			
ESlideNoteManagerForPhone:lblNoteTitle	Slide Note	슬라이드 노트	幻灯片备注
ESlideNoteManagerForPhone:lblHint	You can write a note here.	노트를 입력하세요	请输入备注
ESlideNoteManagerForPhone:textLengOver	You can only enter up to 1,024 characters.	1024자 이상은 입력할 수 없습니다.	最多可输入 1024 个字符
			
ESlideNoteManager:lblHint	Enter content.	노트 내용을 입력하세요.	请输入备注内容
ESlideNoteManager:textLengOver	Only up to 1,024 characters can be entered.	1024자 이상은 입력할 수 없습니다.	最多可输入 1024 个字符
			
ESlideShowManager:lastpage	The slide show ended.\nTo exit, please tap the screen twice.	슬라이드 쇼가 끝났습니다.\n 끝내려면 더블 탭 해 주세요.	幻灯片放映已结束！\n请双击屏幕退出。
ESlideShowManager:DOC_PROTECT	Protected documents cannot be edited.	보호 문서는 편집을 지원하지 않습니다.	不支持编辑设置保护的文件
ESlideShowManager:DOC_PASSWORD_FILE	Password-protected documents cannot be edited.	암호가 설정된 문서는 편집을\n 지원하지 않습니다.	不支持编辑设置密码的文件
ESlideShowManager:DOC_PASSWORD_FILE_LINK	Pen annotations cannot be saved in password-protected documents.	암호문서는 슬라이드 쇼의 잉크를\n저장하지 않습니다.	(*)Password-protected documents cannot save the ink.
ESlideShowManager:CannotSupportVideo	This video format is not supported.	지원하지 않는 동영상 파일입니다.	不支持的视频文件！
ESlideShowManager:CannotFindVideo	Video file is not found.	동영상 파일을 찾을 수 없습니다.	无法找到视频文件
			
ESlideController:NotPropertyArea	Please select an object or text and click it again.	문서 영역 안의 텍스트나 객체를 선택한 후에 다시 눌러 주세요.	请选择文件内文本或对象后重试
ESlideController:FailedStartingSlideShowAsAllSlideIsHidden	Cannot start the slideshow because all pages are hidden.	슬라이드 쇼 범위 안의 모든 페이지가 숨겨져 있어 슬라이드 쇼를 시작할 수 없습니다.	由于所有幻灯片都被隐藏，因此无法开始幻灯片演示。
			
UMailComposer:mailTitle	%d excluding %@	%@' 외 %d개	\%@\" 外 %d 个"
UMailComposer:mailAccountError	You are not registered.\nPlease sign up first.	이메일 계정이 없습니다.\n이메일 계정 등록 후 사용 가능합니다.	没有电子邮箱账户！\n注册电子邮箱账户后即可使用。
UMailComposer:networkError	You are not connected to a network. Please check your internet \n connection or Wi-Fi setting.	네트워크 연결이 꺼져 있습니다.\n셀룰러 데이터 또는 Wi-Fi 연결 후\n사용해 주세요.	网络连接已断开！请在连接蜂窝移动数据或 Wi-Fi 后使用。
UMailComposer:fileSizeError	Size greater than 20 MB cannot be sent.	20MB이상의 메일은 전송할 수 없습니다.	无法发送超过 20MB 的电子邮件！
UMailComposer:sentMail	Link has been sent successfully.	링크 전달이 완료되었습니다.	已发送链接
UMailComposer:failSentMail	Failed to send a link	링크 보내기에 실패 했습니다.	发送链接失败
UMailComposer:FXPopShareVC_sendMail	Sent	전송이 완료되었습니다.	传输已经完成。
			
EPSegsController:btnBack	Back	이전	返回
EPSegsController:btnOkay	Done	완료	完成
EPSegsController:Font	Font	글꼴	字体
EPSegsController:penDraw	Edit with Pen	펜 수정	更改墨笔
EPSegsController:Paragraph	Paragraph	단락	段落
EPSegsController:Format	Format	서식	格式
EPSegsController:TXT_Format	Settings	설정	设置
EPSegsController:Style	Styles	스타일	样式
EPSegsController:Chart	Chart	차트	图表
EPSegsController:Layout	Layout	레이아웃	布局
EPSegsController:Arrange	Alignment	맞춤	排列
EPSegsController:Display	Display Form	표시형식	显示格式
EPSegsController:CellFormat	Format Cells	셀 서식	单元格格式
EPSegsController:Align	Sort	정렬	排序
EPSegsController:ChangeShape	Shapes	도형	更改形状
			
EPFontSize:Title	Font Size	글꼴 크기	字体大小
			
EPTColorTable:ColorPicker	Select Color	색상 선택	选择颜色
EPTColorTable:lblNonColor	There is no color used recently.	최근 사용한 색 없음	没有最近使用的颜色
			
EPTColorPicker:lblRGB	RGB	RGB	RGB
EPTColorPicker:lblTitle	Select Color	색상 선택	选择颜色
EPTColorPicker:btnCancel	Cancel	취소	取消
EPTColorPicker:btnConfirm	Done	완료	完成
			
EChangeShape:Title	Shapes	도형	形状
EChangeShape:toastNotSupport3D	This shape is not applicable for 3D rotation.	3차원 회전을 적용할 수 없는 도형입니다.	该形状无法使用三维旋转。
			
EPTFontColor:Title	Font Color	글꼴 색	字体颜色
			
EPTFontEffect:Title	Effects	효과	效果
			
EPTFontEffectMini:Title	Effects	효과	效果
			
EPTFontType:Title	Font	글꼴	字体
EPTFontType:btnFontList	More Fonts	글꼴 더 보기	更多字体
			
EPTFontList:lblBasic	Default Font	기본 글꼴	默认字体
EPTFontList:lblUser	Custom Font	사용자 지정 글꼴	自定义字体
			
EPTFontBgColor:Title	Font Background Color	글자 배경색	字体背景色
			
EPTArrange:Title	Alignment	맞춤	排列
			
EPTArrangeLinebreak:Title	Line Break	텍스트 줄 바꿈	文本换行
			
EPTChartType:Title	Type	타입	类型
			
EPTChartData:Title	Data	데이터	数据
EPTChartData:btnRowCol	Convert Rows/Columns	행/열 전환하기	切换行/列
EPTChartData:lblData	Show Hidden Cell Data	숨겨진 셀의 데이터 보기	查看隐藏单元格的值
			
EPTDisplay:Title	Display Format	표시 형식	显示格式
EPTDisplay:Normal	General	일반	常规
EPTDisplay:Number	Number	숫자	数值
EPTDisplay:Currency	Currency	통화	货币
EPTDisplay:Account	Accounting	회계	会计
EPTDisplay:Date	Date	날짜	日期
EPTDisplay:Time	Time	시간	时间
EPTDisplay:Percentage	Percentage	백분율	百分比
EPTDisplay:Fraction	Fraction	분수	分数
EPTDisplay:Index	Fraction	지수	科学记数
EPTDisplay:Text	Text	텍스트	文本
			
EPTDNum:lblFraction	Decimal	소수 자릿수	小数位数
EPTDNum:lblSymbol	Symbols	기호	符号
EPTDNum:symbol0	None	없음	无
EPTDNum:symbol5	￥ (Japanese)	￥ (일본어)	￥ (日语)
EPTDNum:symbol6	￥ (Chinese)	￥ (중국어)	￥ (中文)
EPTDNum:lblNegative	Negative Integers	음수	负数
EPTDNum:lblSeparate	Thousands Separator	1000단위 구분 기호	使用千位分隔符
			
EPTDNumMini:lblTitle	Display Format	표시 형식	显示格式
			
EPTDSimpleCurrency:symbol0	None	없음	无
EPTDSimpleCurrency:symbol5	￥ (Japanese)	￥ (일본어)	￥ (日语)
EPTDSimpleCurrency:symbol6	￥ (Chinese)	￥ (중국어)	￥ (中文)
			
EPTDList:fraction0	Up to one digit (1/4)	한 자릿수 분모 (1/4)	分母为一位数 (1/4)
EPTDList:fraction1	Up to two digits (21/25)	두 자릿수 분모 (21/25)	分母为两位数 (21/25)
EPTDList:fraction2	Up to three digits (312/943)	세 자릿수 분모 (312/943)	分母为三位数 (312/943)
EPTDList:fraction3	As halves (1/2)	분모를 2로 (1/2)	以 2 为分母 (1/2)
EPTDList:fraction4	As quarters (2/4)	분모를 4로 (2/4)	以 4 为分母 (2/4)
EPTDList:fraction5	As eighths (4/8)	분모를 8로 (4/8)	以 8 为分母 (4/8)
EPTDList:fraction6	As sixteenths (8/16)	분모를 16으로 (8/16)	以 16 为分母 (8/16)
EPTDList:fraction7	As tenths (3/10)	분모를 10으로 (3/10)	以 10 为分母 (3/10)
EPTDList:fraction8	As hundredths (30/100)	분모를 100으로 (30/100)	百分之几 (30/100)
			
EPTFormatBorderChart:Title	Borders	테두리	边框
EPTFormatBorderChart:Chart	Chart Borders	차트 테두리	图表边框
EPTFormatBorderChart:Data	Data Borders	데이터 테두리	数据边框
			
EPTFormatEffectChart:Title	Effects	효과	效果
EPTFormatEffectChart:Data	3D Data Display	데이터 입체 표시	数据立体显示
EPTFormatEffectChart:DarkBG	Dark Background	어두운 배경으로 표시	用深色背景显示
			
EPTFormatFontChart:Title	Font	글꼴	字体
EPTFormatFontChart:lblTitle	Size	크기	大小
EPTFormatFontChart:btnFontList	More Fonts	글꼴 더 보기	更多字体
			
EPTFormatFormChart:Title	Display Format	표시 형식	显示格式
EPTFormatFormChart:lblData	Show Original Data	원본 데이터 보기	查看源数据
EPTFormatFormChart:lblZeroPoint	Decimal Digits	소수 자릿수	小数位数
EPTFormatFormChart:lblNegative	Negative Integers	음수	负数
EPTFormatFormChart:segPositive	-1234	-1234	-1234
EPTFormatFormChart:segNegative	-1234	-1234	-1234
			
EPTFormatFillColorShape:Title	Fill	채우기	填充
EPTFormatFillColorShape:lblAlpha	Transparency (%)	투명도 (%)	透明度 (%)
EPTFormatFillColorShape:color	Color	색상	颜色
EPTFormatFillColorShape:gradation	Gradation	그라데이션	渐变
			
EPTFormatLineShape:Title	Lines	선	线条
EPTFormatLineShape:StickyTitle	Color	색	颜色
EPTFormatLineShape:lblThickness	Thickness (pt)	두께 (pt)	宽度 (pt)
EPTFormatLineShape:lblStartArrow	Begin Arrow	시작 화살표	箭头前端
EPTFormatLineShape:lblEndArrow	End Arrow	끝 화살표	箭头末端
EPTFormatLineShape:lblAlpha	Transparency (%)	투명도 (%)	透明度 (%)
			
EPTFormatEffectShape:Title	Effects	효과	效果
EPTFormatEffectShape:lblNoShadow	No Shadow	그림자 없음	无阴影
EPTFormatEffectShape:lblShadowOuter	Outer	바깥쪽	外部
EPTFormatEffectShape:lblShadowInner	Inner	안쪽	内部
EPTFormatEffectShape:lblShadowPerspective	Perspective	원근감	透视
EPTFormatEffectShape:lblReflect	No Reflection	반사 없음	无映像
EPTFormatEffectShape:lbl3d	No 3D Rotation	3차원 회전 없음	没有三维旋转
EPTFormatEffectShape:segEffect1	Shadow	그림자	阴影
EPTFormatEffectShape:segEffect2	Reflection	반사	映像
EPTFormatEffectShape:segEffect3	3D Rotation	3차원 회전	三维旋转
EPTFormatEffectShape:select3DRotation	Selecting 3D Rotation disables certain formatting effects, such as lines, shadows, reflection, gradation, and transparency.	3차원 회전 효과를 선택하면 일부 서식이 해제될 수 있습니다(그림자, 반사, 투명도).	选择三维旋转效果时，部分格式(线条、阴影、映像、简便、透明度)会被取消。
EPTFormatEffectShape:select3DRotationForPhone1	Select 3D Rotation	3차원 회전 효과를 선택하면	选择三维旋转效果时
EPTFormatEffectShape:select3DRotationForPhone2	cancels certain formatting effects.	일부 서식이 해제됩니다.	部分格式将被取消
			
EPTFormatAlignShape:Title	Align	정렬	排列
EPTFormatAlignShape:lblOrder	Order	순서	顺序
EPTFormatAlignShape:lblTextline	Line Break	텍스트 줄 바꿈	文本换行
EPTFormatAlignShape:lblCustom	Alignment	맞춤	对齐
			
EPTFormatBrightImage:Title	Adjust	조정	调整
EPTFormatBrightImage:lblBright	Brightness	밝기	亮度
EPTFormatBrightImage:lblContrast	Contrast	대비	对比度
EPTFormatBrightImage:btnReset	Reset	기본값으로 되돌리기	重置
			
EPTFormatOutlineTable:Title	Outline	테두리	边框
			
EPTLayoutLabel:Title	Label	레이블	标签
EPTLayoutLabel:lblSubject	Title	제목	标题
EPTLayoutLabel:lblX	X Axis	X 축	水平轴
EPTLayoutLabel:lblY	Y Axis	Y 축	垂直轴
EPTLayoutLabel:lblLegend	Legend	범례	图例
EPTLayoutLabel:alertTitleLength	Titles cannot exceed 31 characters.	제목은 31자를 넘어갈 수 없습니다.	标题长度不能超过 31 个字符！
EPTLayoutLabel:alertLabelLength	Labels cannot exceed 31 characters.	레이블은 31자를 넘어갈 수 없습니다.	标签长度不能超过 31 个字符！
EPTLayoutLabel:alertXAxisLabelLength	X axis cannot exceed 31 characters.	X축 레이블은 31자를 넘을 수 없습니다.	水平轴标签长度不能超过 31 个字符！
EPTLayoutLabel:alertYAxisLabelLength	Y axis cannot exceed 31 characters.	Y축 레이블은 31자를 넘을 수 없습니다.	垂直轴标签长度不能超过 31 个字符！
			
EPTLayoutAxis:Title	Axis	축	坐标轴
EPTLayoutAxis:lblData	Data Label	데이터 레이블	数据标签
EPTLayoutAxis:lblAxis	Axis Label	축 레이블	轴标签
EPTLayoutAxis:lblAxisX	Tilt X Axis Label	X축 레이블 기울기	旋转水平轴标签
EPTLayoutAxis:lblAxisY	Tilt Y Axis Label	Y축 레이블 기울기	旋转水平轴标签
EPTLayoutAxis:lblAxisLine	Axis Line	축 선	轴线
EPTLayoutAxis:lblAxisLog	Y Axis Log Markings	Y축 로그 눈금	垂直轴对数刻度
			
EPTLayoutGradation:Title	Scale Mark	눈금선	刻度线
EPTLayoutGradation:lblX	X Axis Scale Mark	X축 눈금선	水平轴刻度线
EPTLayoutGradation:lblY	Y Axis Scale Mark	Y축 눈금선	垂直轴刻度线
EPTLayoutGradation:lblDisplay	Show Markings	눈금 표시	刻度线标记
			
EPTStyle:Title	Text	텍스트	文本
EPTStyle:listNone	None	없음	无
EPTStyle:list0	Standard	표준	标准
EPTStyle:list1	Title 1	제목 1	标题1
EPTStyle:list2	Title 2	제목 2	标题2
EPTStyle:list3	Title 3	제목 3	标题3
EPTStyle:list4	Subtitle	소제목	副标题
EPTStyle:list5	Strong Emphasis	강한 강조	明显强调
EPTStyle:list6	Strong Reference	강한 참조	明显引用
			
EPTStyleChart:Title	Charts	차트	图表
			
EPTStyleImage:Title	Images	이미지	图片
			
EPTStyleLine:Title	Lines	선	线条
			
EPTStyleShape:Title	Shapes	도형	形状
			
EPTStyleTable:Title	Tables	테이블	表格
			
EPParaAlign:Title	Alignment	맞춤	对齐
			
EPTextSetting:Title	Format	서식	格式
			
EPParaTextSymbol:Title	Bullets and Numbering	글머리 기호/번호	项目符号/编号
EPParaTextSymbol:lblExistSymbol	No Bullets and Numbering	글머리 기호/번호 없음	没有项目符号/编号
EPParaTextSymbol:lblSetValue	Restart Numbering	번호 새로 매기기	重新编号
			
EPParaIndent:Title	Indentation	들여쓰기	缩进
EPParaIndent:lblLeft	Left (pt)	왼쪽 (pt)	左侧 (pt)
EPParaIndent:lblRight	Right (pt)	오른쪽 (pt)	右侧 (pt)
EPParaIndent:lblFirst	Indent first line (pt)	첫 째줄 들여쓰기 (pt)	首行缩进 (pt)
			
EPParaSpace:Title	Space	간격	间距
EPParaSpace:lblLineSpace	Line Spacing	줄 간격	行距
EPParaSpace:lblParaHead	Before paragraph (pt)	단락 앞 간격 (pt)	段前 (pt)
EPParaSpace:lblParaTail	After paragraph (pt)	단락 뒤 간격 (pt)	段后 (pt)
			
EPParaDirection:Title	Text Direction	텍스트 방향	文本方向
EPParaDirection:lblInputDir	Text Input Direction	글 입력 방향	文字输入方向
EPParaDirection:textList0	Horizontal	가로	水平
EPParaDirection:textList1	Vertical	세로	垂直
EPParaDirection:textList2	Rotate all text in 90 degrees	모든 텍스트 90도 회전	所有文本旋转 90°
EPParaDirection:textList3	Rotate all text in 270 degrees	모든 텍스트 270도 회전	所有文本旋转 270°
EPParaDirection:textList4	Rotate footnote words in 270 degrees	전각단어 270도 회전	全角单词旋转 270°
EPParaDirection:textList5	Vertical (Left to right)	세로형 (왼쪽에서 오른쪽으로)	竖排 (从左到右)
EPParaDirection:textList6	Vertical (Right to left)	세로형 (오른쪽에서 왼쪽으로)	竖排 (从右到左)
EPParaDirection:inputList0	Left to right	왼쪽에서 오른쪽으로	从左到右
EPParaDirection:inputList1	Right to left	오른쪽에서 왼쪽으로	从右到左
			
EPTextFontSize:lblTitle	Font Size	글꼴 크기	字体大小
EPTextFontSize:btnDone	Done	완료	完成
EPTextFontSize:btnCancel	Cancel	취소	取消
EPTextFontSize:encoding1	The encoding settings have been changed.	인코딩 설정이 변경되었습니다.	编码设置已更改
EPTextFontSize:encoding2	Please re-open the document.	문서를 다시 열어주세요.	请重新打开文件
			
EPTextFontStyle:lblTitle	Font	글꼴	字体
			
EPTextTheme:lblTitle	Themes	테마	主题
			
EPTextEncoding:lblTitle	Encoding	인코딩	编码
			
EColorPicker:lblTitle	Select Color	색상 선택	选择颜色
EColorPicker:lblRGB	RGB	RGB	RGB
EColorPicker:btnCancel	Cancel	취소	取消
EColorPicker:btnConfirm	Done	완료	完成
			
ECaptureBar:captureTitle	Screenshot	화면 캡쳐	屏幕截图
ECaptureBar:captureDone	Done	완료	完成
ECaptureBar:SaveToGallery	Clipped files are saved in Picture.	클리핑한 파일은 사진에 저장됩니다.	被裁剪的文件保存到照片
			
ECaptureController:SaveToGallery	Clipped files are saved in Picture.	클리핑한 파일은 사진에 저장됩니다.	被裁剪的文件保存到照片
			
EFindBar:btnDone	Close	닫기	关闭
EFindBar:msgFailSearch	No matching items were found.	일치하는 항목이 없습니다.	没有一致的内容
EFindBar:msgEndSearch	Finished searching the document.	문서 검색을 마쳤습니다.	已结束文件搜索！
EFindBar:msgReplaceAll	%d have been replaced.	%d개가 바뀌었습니다.	已替换 %d 个！
EFindBar:msgReplaceOver	Up to 100 items can be replaced at the same time.\nTo continue,\nselect Replace All.	최대 100개까지 한 번에 변경이\n가능합니다. 계속 진행하시려면\n'모두 바꾸기'를 선택해 주세요.	一次最多可替换 100 个，继续请选择\替换全部\"。"
EFindBar:placeholderFind	Find	찾기	查找
EFindBar:placeholderReplace	Replace	바꾸기	替换
EFindBar:alertProtected	Protected sheets cannot be edited.	보호된 시트는 편집할 수 없습니다.	不能编辑设置保护的电子表格！
EFindBar:alertLimitLength	Only up to 40 characters can be entered.	최대 40자 이상은 입력할 수 없습니다.	最多可输入 40 个字符
			
EFindBarForPhone:btnDone	Close	닫기	关闭
EFindBarForPhone:placeholderFind	Find	찾기	查找
EFindBarForPhone:placeholderReplace	Replace	바꾸기	替换
			
EMaskBar:btnDone	Done	완료	完成
EMaskBar:btnClose	Close	닫기	关闭
			
EHeaderFooterBar:HeaderTitle	Edit Header	머리글 편집	编辑页眉
EHeaderFooterBar:FooterTitle	Edit Footer	바닥글 편집	编辑页脚
EHeaderFooterBar:btnDone	Done	완료	完成
EHeaderFooterBar:btnCancel	Cancel	취소	取消
			
ESheetController:SuccessReCal	Recalculated.	재계산 완료	完成重新计算
ESheetController:FailReCal	Failed to recalculate.	재계산 실패	重新计算失败
ESheetController:ProtectNotEdit	Protected sheets cannot be edited.	보호된 시트는 편집할 수 없습니다.	不能编辑设置保护的电子表格！
ESheetController:PivotNotEditForPad	Sheets containing pivot tables cannot be edited or deleted.	피벗 테이블이 포함된 시트는 편집 또는 삭제할 수 없습니다.	无法编辑或删除包含数据透视表的工作表。
ESheetController:PivotNotEditForPhone	Sheets containing pivot tables\ncannot be edited or deleted.	피벗 테이블이 포함된 시트는\n편집 또는 삭제할 수 없습니다.	无法编辑或删除包含数据透视表的工作表。
ESheetController:unableInsertChartOfAreaType	2 or more areas of the same type\nare required for surface charts.	표면형 차트에는 계열이 2개 이상\n필요합니다.	曲面图需要2个以上系列。
ESheetController:allertLogForMinus	Log charts cannot display negative integers and 0 because only positive integers can be interpreted with the log markings.	로그 차트에서는 음수나 0을 정확히 나타낼 수 없습니다. 로그 눈금 간격에서는 양수만 해석되기 때문입니다.	由于对数刻度线只能解析正数，因此对数图表无法正确显示复数或 0 。
ESheetController:lblNotDrawFreezeSheet	Drawing memo is unavailable in freeze panes.	틀 고정 상태에서는 그리기 메모를\n사용 할 수 없습니다.	在冻结状态下，不能使用手绘批注。
ESheetController:restrictEdit	Editing feature is not supported on horizontal mode. Try on vertical mode.	가로모드에서는 편집을 지원하지 않습니다. 세로모드로 돌려보세요.	编辑功能不支持横向模式。尝试在垂直模式。
			
ESheetManager:toastProtect	Protect	보호	保护
ESheetManager:toastUnprotect	Cancel Protection	보호 해제	解除保护
ESheetManager:overSheetTabNameLength	Sheet's tab names cannot exceed 31 characters.	시트 탭의 이름은 31자를 넘을 수 없습니다.	工作表名称不能超过 31 个字符！
ESheetManager:emptySheetTabName	Please name the sheet tab.	시트 탭의 이름을 입력해 주세요.	请输入工作表名称
ESheetManager:specialCharacter	Special characters (\\, /, :, *, ?, \, “, <, >, and |)\ncannot be used.	특수문자 (\\ / : * ? \ “ < > |)는\n사용할 수 없습니다.	不能使用特殊字符 (\\ / : * ? \ “ < > |)！
ESheetManager:dupName	This sheet tab name already exists.	같은 이름의 시트 탭이 존재합니다.	已有同名的工作表
ESheetManager:delete	Do you want to delete?	삭제하시겠습니까?	要删除吗？
ESheetManager:btnYes	Yes	예	是
ESheetManager:btnNo	No	아니오	否
ESheetManager:UnprotectionSheet	(번)암호로 보호된 시트의 암호 해제 기능은 지원되지 않습니다.	(번)암호로 보호된 시트의 암호 해제 기능은 지원되지 않습니다.	暂不提供对加密工作表的解密功能。
			
ESheetFilterManager:WhenTryInsertCellOnFilterRange	Inserting the cells can affect the filtering area. Please cancel the filters, and then try it again.	셀 삽입 시, 필터링된 범위가 변경될 수 있습니다. \n필터를 해제한 뒤 다시 시도해주시기 바랍니다.	插入单元格时，筛选范围会被更改。请取消筛选后再插入单元格。
			
ESheetInputCtlr:cycleReferenceError	Unable to calculate exactly\nbecause the formula includes a circular reference.	수식에 순환 참조가 포함되어\n제대로 계산할 수 없습니다.	因公式中包含有循环引用，无法正常计算！
			
ESheetOption:lblTitle	Conditional Formatting	조건부 서식	条件格式
ESheetOption:btnOk	Done	완료	完成
ESheetOption:btnCancel	Cancel	취소	取消
ESheetOption:lblOrderTitle	Emphasize Cells	셀 강조	突出显示单元格
ESheetOption:lblOrderGreaterThan	Greater Than	보다 큼	大于
ESheetOption:lblOrderLessThan	Smaller Than	보다 작음	小于
ESheetOption:lblOrderEqual	Equal	같음	等于
ESheetOption:lblOrderDuplicate	Duplicate Value	중복 값	重复值
ESheetOption:lblRuleTitle	Top/Bottom Rules	상위/하위 규칙	选取规则
ESheetOption:lblRuleTop10N	Top 10 Items	상위 10개	前 10 项
ESheetOption:lblRuleTop10P	Top 10%	상위 10%	前 10%
ESheetOption:lblRuleBottom10N	Bottom 10 Items	하위 10개	最后 10 项
ESheetOption:lblRuleBottom10P	Bottom 10%	하위 10%	最后 10%
ESheetOption:lblColorTitle	Color	색조	色阶
ESheetOption:lblColorGYR	Green, Yellow Red	녹,노,빨	绿-黄-红
ESheetOption:lblColorRYG	Red, Yellow, Green	빨,노,녹	红-黄-绿
ESheetOption:lblColorWR	White, Red	흰,빨	白-红
ESheetOption:lblColorRW	Red, White	빨,흰	红-白
ESheetOption:lblIconTitle	Icons	아이콘	图标
ESheetOption:btnClear	Clear Rules	규칙 지우기	清除规则
			
ESheetDataAdjust:lblTitle	Adjust Data Range	데이터 범위 조절	调整数据范围
ESheetDataAdjust:btnCancel	Cancel	취소	取消
ESheetDataAdjust:btnConfirm	Done	완료	完成
			
EMemoManager:lblMemoTitle	Comment	메모	评论
EMemoManager:lblMemoHint	Enter a comment.	메모를 입력하세요.	请输入评论
			
EMemo:lblMemoTitle	Comment	메모	评论
EMemo:lblMemoHint	Enter a comment.	메모를 입력하세요.	请输入评论
			
EAlignSetter:lblTitle	Sort	정렬	排序
EAlignSetter:lblSub1	Alignment	맞춤	对齐
EAlignSetter:lblSub2	Order	순서	顺序
			
PopZipExtract:zipPassword1	Enter the password to extract the item.	압축 비밀번호를 입력해 주세요.	请输入压缩密码
PopZipExtract:zipPassword2	The password does not match.\nPlease try it again.?	비밀번호가 일치하지 않습니다.\n다시 시도해 주세요.	密码不一致！\n请重试。
PopZipExtract:extract	Do you want to extract?	압축을 해제 하시겠습니까?	要进行解压吗？
PopZipExtract:extract_cloud	Do you want to extract %@ zip files? \nIt will be saved in your local storage.	압축을 해제 하시겠습니까?\n압축 해제 시 로컬 스토리지에 저장 됩니다.	要解压吗？\n解压后将会保存到本地存储。
PopZipExtract:extract_temp	Do you want to extract %@ zip files? \nIt will be saved in the temporary storage.	압축을 해제 하시겠습니까?\n압축 해제 시 임시 스토리지에 저장 됩니다.	要解压吗？\n解压后将会保存到临时文件夹。
PopZipExtract:extracting	Extracting file(s)...	압축 해제 중...	正在解压文件……
PopZipExtract:equarFileOverright?	The file already exists.\nDo you want to overwrite it?	동일한 파일이 존재합니다. 덮어 쓰시겠습니까?	已有相同文件，要覆盖吗？
PopZipExtract:Cancel	Cancel	취소	取消
PopZipExtract:OK	OK	확인	确认
PopZipExtract:btnNo	No	아니오	不是
PopZipExtract:btnYes	Yes	예	是
PopZipExtract:unsupport	There is %d unsupported file(s).\n The files will not be shown in the list.	%d개의 미지원 파일이 있습니다.\n해당 파일은 목록에서 볼 수 없습니다.	有 %d 个不支持的文件！\n这些文件不会显示在列表中。
PopZipExtract:passwordPlaceholder	Enter Password	비밀번호 입력	输入密码
PopZipExtract:headtitle	Extract	압축 풀기	解压
PopZipExtract:unable	Unable to extract the item.	압축을 해제할 수 없습니다.	无法进行解压！
PopZipExtract:completionExtract	Extracted.	압축 해제 완료	已完成解压！
			
EEditController:lblZoom:MAX	Maximum	최대	最大
EEditController:lblZoom:MIN	Minimum	최소	最小
			
EInpopController:SelectAll	Select All	전체 선택	全选
EInpopController:CellSelect	Select Cells	셀 선택	选择单元格
EInpopController:Memo	Comment	메모	评论
EInpopController:MemoAdd	New comments	메모 추가	添加评论
EInpopController:MemoEdit	Show comments	메모 보기	编辑评论
EInpopController:CopyForm	Copy Format	서식 복사	复制格式
EInpopController:PasteForm	Paste Format	서식 붙여넣기	粘贴格式
EInpopController:ChangeUppercase	To uppercase	대문자로	全部大写
EInpopController:ChangeLowercase	To lowercase	소문자로	全部小写
EInpopController:AddHyperlink	Add Hyperlink	하이퍼링크 추가	添加超链接
EInpopController:EditHyperlink	Edit hyperlink	하이퍼링크 편집	编辑超链接
EInpopController:ActionHyperlink	Open hyperlink	하이퍼링크 실행	打开超链接
EInpopController:DeleteHyperlink	Delete hyperlink	하이퍼링크 삭제	删除超链接
EInpopController:AddContact	Add Contact in Polaris Office Address Book	주소록에 추가	添加到通讯录
EInpopController:Footnote	Footnote	각주	脚注
EInpopController:Endnote	Endnote	미주	尾注
EInpopController:RecommendWord	View Suggested Words	추천단어 보기	查看推荐单词
EInpopController:SearchGoogle	Search Google	구글 검색	用谷歌搜索
EInpopController:SearchWikipedia	Search Wikipedia	위키피디아 검색	用维基百科搜索
EInpopController:Dictionary	Link Dictionary	사전 연동	查找词典
EInpopController:ChangeImage	Change Image	이미지 바꾸기	更换图片
EInpopController:CutImage	Cut	자르기	裁剪
EInpopController:AdjustDataRange	Adjust Data Range	데이터 범위 조절	调整数据范围
EInpopController:DataSheet	Data Sheet	데이터 시트	数据工作表
EInpopController:AdjustColumWidth	Make column widths equal	열 너비를 같게	分布列
EInpopController:AdjustRowHeight	Make row heights equal	행 높이를 같게	分布行
EInpopController:CellInsert	Insert	삽입	插入
EInpopController:Split	Split into cells	셀 분할	拆分单元格
EInpopController:Merge	Merge cells	셀 병합	合并单元格
EInpopController:DeleteColum	Delete columns	열 삭제	删除列
EInpopController:DeleteRow	Delete rows	행 삭제	删除行
EInpopController:ColumSelect	Select columns	열 선택	选择列
EInpopController:RowSelect	Select rows	행 선택	选择行
EInpopController:AllCellSelect	Select all cells	모든 셀 선택	选择所有单元格
EInpopController:Group	Group	그룹	组合
EInpopController:ReleaseGroup	Ungroup	그룹 해제	取消组合
EInpopController:PasteValue	Paste value	값 붙여넣기	粘贴值
EInpopController:PasteFormula	Paste formula	수식 붙여넣기	粘贴公式
EInpopController:ColumInsert	Insert columns	열 삽입	插入列
EInpopController:RowInsert	Insert rows	행 삽입	插入行
EInpopController:DeleteCell	Delete cells	셀 삭제	删除单元格
EInpopController:Delete	Delete	지우기	清除
EInpopController:HideColum	Hide columns	열 숨기기	隐藏列
EInpopController:ColumWidth	Column Width	열 너비	列宽
EInpopController:ColumAutoSize	Auto-size columns	열 너비 자동 맞춤	自动调整列宽
EInpopController:HideRow	Hide rows	행 숨기기	隐藏行
EInpopController:RowHeight	Row Height	행 높이	行高
EInpopController:RowAutoSize	Auto-size rows	행 높이 자동 맞춤	自动调整行高
EInpopController:ConditionalForm	Conditional Formatting	조건부 서식	条件格式
EInpopController:UnhideColum	Show hidden columns	열 숨기기 취소	取消隐藏列
EInpopController:UnhideRow	Show hidden rows	행 숨기기 취소	取消隐藏行
EInpopController:annotDelete	Delete	삭제	删除
EInpopController:annotEdit	Edit Note	노트 편집	编辑备注
EInpopController:annotProp	Properties	속성	属性
EInpopController:annotLink	Hyperlink	하이퍼링크	超链接
EInpopController:Resize	Size	크기	大小
EInpopController:Rotate	Rotate	회전	旋转
EInpopController:ResizeNRotate	Size and Rotation	크기 및 회전	大小及旋转
EInpopController:InlineWithLine	(number) text indented	텍스트 줄 안	嵌入型
EInpopController:InlineTopBottom	(number) top/bottom	위/아래	上/下
EInpopController:InlineWithText	(number) text front	텍스트 앞	浮于文字上方
EInpopController:Bottom	(number) text back	텍스트 뒤	衬于文字下方
EInpopController:Through	(number) square	정사각형	正方形
EInpopController:SlideDuplicate	Duplicate	복제	复制
EInpopController:SlideLayout	Layout	레이아웃	布局
EInpopController:SlideChangeScreen	Rotate Screen	화면 전환	切换
EInpopController:SlideBackground	Background	배경	背景
EInpopController:SlideHide	Hide	숨기기	隐藏
EInpopController:SlideUnhide	Show hidden	숨기기 취소	取消隐藏
EInpopController:AutoCalculate	Automatic Calculation	자동연산	自动计算
EInpopController:CannotEditMergedCell	Merged cells cannot be modified separately.	병합된 셀의 일부분을 변경할 수 없습니다.	无法修改合并单元格的一部分
EInpopController:AddedContact	This contact has been added to your address book.	주소록에 추가 되었습니다.	已添加到通讯录
EInpopController:CannotAddContact	An error occurred while adding the contact to your address book.	주소록에 추가하는 중에 에러가 발생 했습니다.	添加到通讯录时，发生错误！
EInpopController:Order	Order	순서	顺序
EInpopController:Textline	Wrap Text	텍스트 줄 바꿈	文本换行
EInpopController:Align	Alignment	맞춤	排序
EInpopController:Multi	Multi Selection	다중 선택	选择题
			
EPDFController:lblHint	Enter content.	내용을 입력하세요.	请输入内容
EPDFController:lblDelNote	Do you want to delete the notes that are you are currently viewing?	현재 보고 있는 노트를 지우시겠습니까?	要删除当前查看的备注吗？
			
EPDFAnnotController:titleLB	Annotation List (%d)	주석 목록 (%d)	注释列表 (%d)
EPDFAnnotController:btnEdit	Edit	편집	编辑
EPDFAnnotController:btnDone	Close	닫기	关闭
EPDFAnnotController:btnRecycle	Delete	삭제	删除
EPDFAnnotController:btnRecycleOK	Done	완료	完成
			
EPDFDrawControllerForPhone:btnDone	Close	닫기	关闭
			
EInpopMenu:slideDelete	Delete	삭제	删除
EInpopMenu:slideCopy	Copy	복사	复制
EInpopMenu:slideCut	Cut	잘라내기	剪切
EInpopMenu:slidePaste	Paste	붙여넣기	粘贴
EInpopMenu:sheetInsert	Insert	삽입	插入
EInpopMenu:sheetCopy	Copy	복제	复制
EInpopMenu:sheetDelete	Delete	삭제	删除
EInpopMenu:sheetProtect	Protect	보호 설정	设置保护
EInpopMenu:sheetUnprotect	Unrotect	보호 해제	解除保护
			
ESlideChangeScreen:Title	Rotate Screen	화면 전환	切换
ESlideChangeScreen:lblTot	Apply to all slides	전체 슬라이드 적용	应用于全部幻灯片
ESlideChangeScreen:lblChangeTime	Switch Timing	전환 시점	切换时间
ESlideChangeScreen:lblNowChange	Switch when you tab the screen	화면을 누르면 전환	点击屏幕时切换
ESlideChangeScreen:lblDelayChange	Switch automatically after 3 seconds	3초 후 자동 전환	3 秒后自动切换
ESlideChangeScreen:lblSoft	Subtle	은은한 효과	细微效果
ESlideChangeScreen:lblFancy	Splendid Effect	화려한 효과	华丽效果
ESlideChangeScreen:lblActive	Dynamic Contents	동적 콘텐츠	动态内容
ESlideChangeScreen:lblOption	Options	옵션	可选
ESlideChangeScreen:btnClose	Close	닫기	关闭
ESlideChangeScreen:lblSoft00	None	없음	无
ESlideChangeScreen:lblSoft01	Cut	자르기	切出
ESlideChangeScreen:lblSoft02	Fade	밝기변화	淡出
ESlideChangeScreen:lblSoft03	Push	밀어내기	推进
ESlideChangeScreen:lblSoft04	Wipe	닦아내기	擦除
ESlideChangeScreen:lblSoft05	Split	나누기	分割
ESlideChangeScreen:lblSoft06	Show	나타내기	显示
ESlideChangeScreen:lblSoft07	Random Bars	실선무늬	随机线条
ESlideChangeScreen:lblSoft08	Shape	도형	形状
ESlideChangeScreen:lblSoft09	Uncover	당기기	揭开
ESlideChangeScreen:lblSoft10	Cover	덮기	覆盖
ESlideChangeScreen:lblSoft11	Flash	깜박이기	闪光
ESlideChangeScreen:lblFancy00	None	없음	无
ESlideChangeScreen:lblFancy01	Dissolve	흩어 뿌리기	溶解
ESlideChangeScreen:lblFancy02	Checkerboard	바둑판 무늬	棋盘
ESlideChangeScreen:lblFancy03	Blinds	블라인드	百叶窗
ESlideChangeScreen:lblFancy04	Clock	시계	时钟
ESlideChangeScreen:lblFancy05	Wave	파장	涟漪
ESlideChangeScreen:lblFancy06	Honeycomb	벌집형	蜂巢
ESlideChangeScreen:lblFancy07	Glitter	반짝이기	闪耀
ESlideChangeScreen:lblFancy08	Vortex	소용돌이	涡流
ESlideChangeScreen:lblFancy09	Shred	조각	碎片
ESlideChangeScreen:lblFancy10	Switch	전환	切换
ESlideChangeScreen:lblFancy11	Flip	넘기기	翻转
ESlideChangeScreen:lblFancy12	Gallery	갤러리	库
ESlideChangeScreen:lblFancy13	Cube	큐브	立方体
ESlideChangeScreen:lblFancy14	Doors	문	门
ESlideChangeScreen:lblFancy15	Box	상자	框
ESlideChangeScreen:lblFancy16	Zoom	확대/축소	缩放
ESlideChangeScreen:lblDynamic00	None	없음	无
ESlideChangeScreen:lblDynamic01	Moving	이동	平移
ESlideChangeScreen:lblDynamic02	Ferris Wheel	관람차	摩天轮
ESlideChangeScreen:lblDynamic03	Conveyor	컨베이어	传送带
ESlideChangeScreen:lblDynamic04	Rotate	회전	旋转
ESlideChangeScreen:lblDynamic05	Window	창문	窗口
ESlideChangeScreen:lblDynamic06	Orbit	궤도	轨道
ESlideChangeScreen:lblDynamic07	Fly In	날기	飞过
			
EPopPDFRects:figure1	Circle	원형	圆形
EPopPDFRects:figure2	Square	사각형	四边形
EPopPDFRects:figure3	Arrow	화살표	箭头
EPopPDFRects:figure4	Line	선	线条
			
EPopColorTable:lblNonColor	No colors were used recently.	최근 사용한 색 없음	没有最近使用的颜色
			
EWordController:template	Templates	템플릿	模板
			
EPopInsertCell:lblTitle	Insert Cells	셀 삽입	插入单元格
EPopInsertCell:other_lblRight	Insert a column to the left	왼쪽에 열 삽입	在左侧插入列
EPopInsertCell:other_lblDown	Insert a column to the right	오른쪽에 열 삽입	在右侧插入列
EPopInsertCell:other_lblRow	Insert a row at the top	위에 행 삽입	在上方插入行
EPopInsertCell:other_lblCol	Insert a row at the bottom	아래에 행 삽입	在下方插入行
EPopInsertCell:sheet_lblRight	Shift cells right	셀을 오른쪽으로 밀기	单元格右移
EPopInsertCell:sheet_lblDown	Shift cells down	셀을 아래로 밀기	单元格下移
EPopInsertCell:sheet_lblRow	Entire row	행 전체	整行
EPopInsertCell:sheet_lblCol	Entire column	열 전체	整列
			
EDataSheet:lblTitle	Data Sheet	데이터 시트	数据工作表
EDataSheet:btnCancel	Cancel	취소	取消
EDataSheet:btnOK	Done	완료	完成
			
EInsertImagePicker:lblCountPhotoVideo	%d pictures, %d videos	%d개의 사진, %d개의 비디오	%d 张照片、%d 段视频
EInsertImagePicker:lblCountPhoto	%d pictures	%d개의 사진	%d 张照片
EInsertImagePicker:lblCountVideo	%d videos	%d개의 비디오	%d 段视频
			
PopGuideToast:plblLine1	Slide from right to left to switch to Edit mode,	오른쪽에서 왼쪽으로 밀면 편집 모드로 전환되며,	从右向左拖动屏幕时，转换到编辑模式
PopGuideToast:plblLine2	Slide from left to right to switch to View mode.	반대 방향으로 밀면 보기 모드로 전환됩니다. 	从左向右拖动屏幕时，转换到只读模式。
PopGuideToast:plblPointText1	Edit mode	편집 모드	编辑模式
PopGuideToast:plblPointText2	Review mode	검토 모드	审阅模式
PopGuideToast:plblLine3	If you drag it from left to right, it moves to an upper folder.	왼쪽에서 오른쪽으로 밀면 상위 폴더로 이동됩니다.	向右滑动屏幕时，转到上级文件夹
			
BPopFileBrowser:btnCancel	Cancel	취소	取消
BPopFileBrowser:lblTitle	Switch Document	문서 교체	替换文件
			
BPopPointerSetting:lblTitle	Pen Settings	펜 설정	墨笔设置
			
ULocalStorage:language	en.lproj	ko.lproj	en.lproj
			
UPCloudManager:title	%@/%@ has sent %@.	%@ / %@ 가 %@을 보냈습니다	%@ / %@ 发送 %@
UPCloudManager:storageName	%@'s Polaris	%@의 Polaris	%@ 的 Polaris
UPCloudManager:contents	Click %@ below to check the document in Polaris Office. \n	Polaris Office에서 %@ 아래를 클릭하여 문서를 확인하세요.\n	请在 Polaris Office 点击 %@ 下方确认文件。\n
			
UPCloudErrorManager:excessUsagePaid	Your storage is full.\nData cannot be synchronized or created.\nTo synchronize or create a document, please delete some files.	저장공간이 초과되어 \n동기화를 할 수 없습니다.\n 동기화를 하시려면 기존 문서를\n삭제해 주세요.	由于存储空间已满，无法进行同步。\n请删除原有文件，完成同步。
UPCloudErrorManager:119	The account has been deleted. You are now being disconnected from the service.	파라미터 오류	参数错误
UPCloudErrorManager:105	Parameter error	계정이 삭제되어 로그아웃 됩니다.	由于账户已被删除，将会退出登录。
UPCloudErrorManager:120	The account's password has been changed. You are now being logged out.	비밀번호 변경되어 로그아웃 됩니다.	由于密码已被更改，将会退出登录。
UPCloudErrorManager:existID	This e-mail address already exists.	이미 존재하는 E-mail입니다.	已有相同电子邮箱地址。
UPCloudErrorManager:no_such_file	Invalid file.	유효하지 않은 파일입니다.	无效文件！
UPCloudErrorManager:501	No file is included.	파일이 포함되어 있지 않습니다.	没有包含文件！
UPCloudErrorManager:502	In full capacity.	최대인원을 초과하였습니다.	超过最大人数！
UPCloudErrorManager:505	The number of files exceeded the maximum limit.	최대 파일 개수 초과	超过最大文件数量！
UPCloudErrorManager:btnPremium	Upgrade Account	계정 업그레이드	升级账户
UPCloudErrorManager:StorageNotEnough	Not enough memory. Please make delete some files and try it again.	단말 저장 공간이 부족합니다.\n저장 공간을 확보한 후\n다시 시도해 주세요.	终端存储空间不足！\n请确保存储空间后重试。
UPCloudErrorManager:-1001	The network is busy.\nPlease try it again later. (%d)	네트워크 상태가 원활하지 않습니다.\n잠시 후 다시 시도해 주세요.(%d)	网络状态不稳定，请稍后再试(%d)
UPCloudErrorManager:117	Device is disconnected by \nother device.	다른 기기에서 디바이스 해제하였습니다.	在另一台设备上解除了设备连接。
UPCloudErrorManager:119	Device is disconnected \nbecause the account has been deleted.	계정 삭제에 의해 디바이스 해제하였습니다.	由于账户被删除，解除了设备连接。
UPCloudErrorManager:120	Device is disconnected because password has changed. \nPlease log in again.	비밀번호가 변경 되었습니다.\n다시 로그인 해주세요.	由于密码被更改，解除了设备连接。
UPCloudErrorManager:Error_AIRPLANE	Please turn off airplane mode to access the data.	네트워크 연결이 꺼져 있습니다.\n셀룰러 데이터 또는 Wi-Fi 연결 후\n사용해 주세요.	网络连接已断开！\n请在连接蜂窝移动数据或 Wi-Fi 后使用。
UPCloudErrorManager:alertNetworkDisconnected	You are not connected to a network. Please check your internet \n connection or Wi-Fi setting.	Wi-Fi가 아닌 셀룰러 데이터를 \n이용하여 연결 시 별도의 데이터 통화료가\n 부과 될 수 있습니다.	网络连接已断开！\n请在连接蜂窝移动数据或 Wi-Fi 后使用。
UPCloudErrorManager:Alert_NetworkDisconnected	You are not connected to a network. Please check your internet \n connection or Wi-Fi setting.	데이터에 접근하려면, \n에어플레인 모드를 해제해 주세요.	要访问数据，请先解除飞行模式。
UPCloudErrorManager:Alert_NetworkDisconnectedWithDownload	You need an internet connection to download the document.\nPlease connect to an internet or Wi-Fi network.	네트워크에 연결되지 않아\n문서를 다운로드 할 수 없습니다.\n셀룰러 데이터 또는 Wi-Fi 연결 후\n사용해 주세요.	由于未连接网络，而无法下载文件。\n请链接蜂窝数据或 Wi-Fi 后使用。
UPCloudErrorManager:Alert_NoMorePop	You need an internet connection to sync the document.\nPlease connect to an internet or Wi-Fi network.	네트워크 연결이 되지 않아\n문서를 동기화 할 수 없습니다.\n셀룰러 데이터 또는 Wi-Fi 연결 후\n사용해 주세요.	由于未连接网络，而无法进行文件同步。\n请连接蜂窝数据或 Wi-Fi 后使用。
UPCloudErrorManager:btnNoMorePop	Do not show again	다시 보지 않기	不再显示
UPCloudErrorManager:onbbibbo	Server is undergoing a maintenance.\nPlease try again after few minutes.\nCompletion : %@	서비스 정기 점검중입니다.\n잠시 후 다시 시도해 주세요.\n완료 예정 시간 : %@	正在进行系统定期检查。\n请稍后重试。\n预计完成时间：%@
UPCloudErrorManager:ontempbbibbo	Server is undergoing an emergency maintenance.\nPlease try again after few minutes.\nCompletion : %@	서비스 긴급 점검중입니다.\n잠시 후 다시 시도해 주세요.\n완료 예정 시간 : %@	正在进行系统紧急检查。\n请稍后重试。\n预计完成时间：%@
UPCloudErrorManager:bbibboplanned	Server maintenance is scheduled.\nStart : %1$s \nCompletion : %@	서비스 점검 예정입니다.\n점검 예정 시간 : %@\n완료 예정 시간 : %@	计划进行系统检查。\n预计开始时间：%@\n预计完成时间：%@
UPCloudErrorManager:onbbibbofailed	Cannot retrieve service status.\nPlease retry in a few minutes.	서비스 상태를 가져올 수 없습니다.\n잠시 후 다시 시도해 주세요.	无法获得业务状态。\n请稍后重试。
UPCloudErrorManager:btnShowAgain	Do not show again	다시 보지 않기	不再显示
UPCloudErrorManager:btnConfirm	OK	확인	确认
UPCloudErrorManager:Timeout	The network is busy.\nPlease try it again later.	네트워크 상태가 원활하지 않습니다.\n잠시 후 다시 시도해 주세요.	网络状态不稳定，请稍后再试
			
UPCloudTaskManager:tasklog1	%@ has been shared.	%@' 를 공유하였습니다.	已共享\%@\"！"
UPCloudTaskManager:tasklog2	%@ has been shared to %@.	%@' 를 '%@' 님에게 공유하였습니다.	已把\%@\"共享给\"%@\"！"
UPCloudTaskManager:tasklog3	%@ has been shared to %d users excluding %@.	%@' 를 '%@' 님 외 %d명에게 공유하였습니다.	已把\%@\"共享给\"%@\"外 %d 名联系人！"
UPCloudTaskManager:tasklog4	Except %@, %d items have been shared to%@.	%@' 외 %d 개를 '%@' 님에게 공유하였습니다.	已把\%@\"外 %d 个文件共享给\"%@\"！"
UPCloudTaskManager:tasklog5	Except %@, %d items have been shared to %d users excluding %@.	%@' 외 %d 개를 '%@' 님 외 %d명에게 공유하였습니다.	已把\%@\"外 %d 个文件共享给\"%@\"外 %d 名联系人。"
UPCloudTaskManager:tasklogtaskdelete	This document is no longer shared.	문서 공유가 중단되었습니다.	文件共享已被中断！
UPCloudTaskManager:tasklogupdate	%@ has been updated.	%@'를 업데이트하였습니다.	已更新\%@\"！"
UPCloudTaskManager:tasklogfileadd1	%@ has been shared.	%@'이 공유되었습니다.	\%@\"已被共享！"
UPCloudTaskManager:tasklogfileadd2	Except %@. %d items have been shared	%@'외 %d개가 공유되었습니다.	\%@\"外 %d 个文件已被共享！"
UPCloudTaskManager:tasklogfilerenamed	The name of the document has been changed from '%@' to '%@'.	문서 이름이 '%@'에서 '%@'로 변경되었습니다.	文件名由\%@\"更改为\"%@\"。"
UPCloudTaskManager:tasklogfiledelete	%@ is no longer shared.	%@'의 공유가 중단되었습니다.	\%@\"的共享已被中断！"
UPCloudTaskManager:tasklogguestadd	%@ has been invited.	%@'님을 초대하였습니다.	已邀请\%@\"！"
UPCloudTaskManager:tasklogguestadd1	%d users excluding %@ have been invited.	%@'님 외 %d명을 초대하였습니다.	已邀请\%@\"外 %d 名联系人！"
UPCloudTaskManager:tasklogguestdelete	%@ no longer has an access to the document.	%@'님과의 문서 공유가 중단되었습니다.	与\%@\"的文件共享已被中断！"
UPCloudTaskManager:tasklogguestdelete2	Except %@, %d users no longer have an access to the document.	%@'님 외 %d명과의 문서 공유가 중단되었습니다.	与\%@\"外 %d 名联系人的文件共享已被中断！"
UPCloudTaskManager:tasklogdelete	%@ no longer has an access to the document.	%@'님과의 문서 공유가 중단되었습니다.	与\%@\"的文件共享已被中断！"
UPCloudTaskManager:tasklogguestzero	%@ no longer has an access to the document.	%@'님과의 문서 공유가 중단되었습니다.	与\%@\"的文件共享已被中断！"
			
UPCloudManager:tryLogin	Please sign in again. (%d)	다시 로그인 해주세요.(%d)	请重新登录！(%d)
			
BPopDocList:lblTitle	Document Information	문서 정보	文件信息
			
EGORefreshTableHeaderView:LastUpdated_1	Most Recent Updated Date	최신 Update 일자	最新更新日期
EGORefreshTableHeaderView:Normal_1	Synchronize Polaris	Polaris 동기화	Polaris 同步
EGORefreshTableHeaderView:Normal_2	Pull down to refresh	화면을 당겨주세요.	下拉刷新
EGORefreshTableHeaderView:Normal_3	Refresh	새로 고침	刷新
EGORefreshTableHeaderView:Normal_4	Pull down to refresh	화면을 당겨주세요.	下拉刷新
EGORefreshTableHeaderView:Pulling_1	Synchronize Polaris	Polaris 동기화	Polaris 同步
EGORefreshTableHeaderView:Pulling_2	Release to refresh	화면을 놓아주세요.	释放刷新
EGORefreshTableHeaderView:Pulling_3	Refresh	새로 고침	刷新
EGORefreshTableHeaderView:Pulling_4	Release to refresh	화면을 놓아주세요.	释放刷新
EGORefreshTableHeaderView:Loading_1	Synchronizing Polaris...	Polaris 동기화 중...	Polaris 正在同步……
EGORefreshTableHeaderView:Loading_2	Please wait.	잠시만 기다려 주세요.	请稍等
EGORefreshTableHeaderView:Loading_3	Refreshing...	새로 고침 중...	正在刷新……
EGORefreshTableHeaderView:Loading_4	Please wait.	잠시만 기다려 주세요.	请稍等
			
ViewController:migrationText	Importing data of the previous version...	이전버전의 데이터를 가져오고 있습니다.	正在获取旧版本数据。
			
FXNoticeConnection:btnShowAgain	Do not show again	다시 보지 않기	不再显示
FXNoticeConnection:btnConfirm	Confirm	확인	确认
			
FXVersionCheckConnection:btnShowAgain	Do not show again	다시 보지 않기	不再显示
FXVersionCheckConnection:btnConfirm	Confirm	확인	确认
FXVersionCheckConnection:btnCancel	Close	닫기	关闭
FXVersionCheckConnection:updateAvailable	There is a new update! \n(Version %@)\n Please update now for better service.	새로운 업데이트가 있습니다.\n(버전 %@)\n원활한 사용을 위해 최신 버전으로 업데이트해주세요.	有新版更新。\n(版本 %@)\n请升级最新版本，以确保业务的正常使用。
FXVersionCheckConnection:updateAvailableMandatory	There is a new update! \n(Version %@)\n For convenient of use, \n please update to the latest version.	새로운 업데이트가 있습니다.\n(버전 %@)\n원활한 사용을 위해 최신 버전으로\n업데이트가 필요합니다.	有新版更新。\n(版本 %@)\n需要升级最新版本，确保业务的正常使用。
			
FXStorageData:cloud	Cloud	클라우드	云盘
			
FXTabVC:Recent	Recent	최근	近期
FXTabVC:Browser	Browse	탐색	浏览
FXTabVC:Share	Share	공유	共享
FXTabVC:Information	Information	정보	信息
FXTabVC:Setting	Setting	설정	设置
			
FXTabBrowserVC:btnEdit_edit	Select	선택	管理
FXTabBrowserVC:btnEdit_done	Done	완료	完成
FXTabBrowserVC:btnEdit_cancel	Cancel	취소	取消
FXTabBrowserVC:lblTitle	Manage Documents	문서 관리	管理文件
FXTabBrowserVC:search	Search	검색	搜索
FXTabBrowserVC:aRenameText	The text entered exceeded the maximum length.	최대 길이를 초과하였습니다.	已超过最大长度！
FXTabBrowserVC:specialCharacter	Special characters (\\, /, :, *, ?, \, “, <, >, and |)\ncannot be used.	특수문자 (\\ / : * ? \ “ < > |)는\n사용할 수 없습니다.	不能使用特殊字符 (\\ / : * ? \ “ < > |)！
FXTabBrowserVC:Error_Editing	Complete editing and then try it again.	편집모드 종료후 실행해 주세요	请关闭编辑模式后运行。
FXTabBrowserVC:MyDocument	My Document	내 문서	我的文件
FXTabBrowserVC:Recent	Recent Document	최근 문서	最近所用文件
FXTabBrowserVC:Shared	Shared Document	공유 문서	共享的文件
FXTabBrowserVC:lblShareTitle	Share it	공유하세요	共享
FXTabBrowserVC:popshare.description.more	Do you want to share %d document(s) excluding %@?	%@' 외 %d개의 문서를 공유하시겠습니까?	要共享\%@\"外 %d 个文件吗？"
FXTabBrowserVC:popshare.description.one	Do you wnat to share %@?	%@' 문서를 공유하시겠습니까?	要共享\%@\"文件吗？"
FXTabBrowserVC:Sort	Sort	정렬	排序
FXTabBrowserVC:NeverSeeAgain	Do not show again	다시 보지 않기	不再显示
FXTabBrowserVC:Open	Done	확인	确认
FXTabBrowserVC:GuestPopTitle	Shared Documents	공유 받은 문서	共享的文档
FXTabBrowserVC:GuestPopMsg	Shared Documents are only available for viewing. Please save files in My Documents to edit shared documents.	공유 받은 문서는 보기만 가능합니다.\n내문서에 다른 이름으로 저장 한 뒤, 편집할 수 있습니다.	由其他人共享的文档只允许阅读。\n以其他文件名保存到我的文档后即可对其进行编辑。
FXTabBrowserVC:PosDescThanks	Thank you for installing Polaris Office Sync. As a thank you, we want give you an additional 300 MB of Polaris Office storage. Please rate us in the app stores!	Desktop 용 Polaris Office Sync를 설치해 주셔서 감사합니다. 감사의 뜻으로 300MB의 보너스 용량을 지급하였습니다. 기분 좋은 느낌을 리뷰로 남겨주세요!	感谢您使用 Polaris Office Sync。给您赠送 300MB 存储空间，以表达我们的谢意。请对我们撰写评论吧！
FXTabBrowserVC:PosBtnReview	Review	리뷰 달기	撰写评论
FXTabBrowserVC:PosBtnClose	Close	닫기	关闭
			
FXStorageLocalVC:btnItunes	Copy from iTunes	iTunes 에서 복사	从 iTunes 进行复制
FXStorageLocalVC:loginError	Failed to log in	로그인 오류	登录错误
FXStorageLocalVC:Logout	Log Out	로그아웃	退出登录
FXStorageLocalVC:CompleteLogout	Complete Logout.	Complete Logout.	完成退出
FXStorageLocalVC:PolarisLink	Polaris Office	Polaris Office	Polaris Office
			
FXStorageCell:delTitle	Delete	삭제	删除
			
FXRecentTitleVC:editDone	Done	완료	完成
FXRecentTitleVC:edit	Edit	편집	编辑
FXRecentTitleVC:recentEditTitle	Select Document	도큐먼트 선택	选择文档
FXRecentTitleVC:search	Search	검색	检索
FXRecentTitleVC:close	Close	닫기	关闭
			
FXBrowserOpVC:sameFolderPath	Cannot work in the same path.	동일한 경로에는 수행할 수 없습니다.	无法在相同路径执行！
FXBrowserOpVC:donotCopyToZip	Cannot save a copy in the Zip folder.	압축폴더 안으로 복사 할 수 없습니다.	不能复制到压缩文件内！
FXBrowserOpVC:donotMoveToZip	Cannot move to the Zip folder.	압축폴더 안으로 이동 할 수 없습니다.	不能移动到压缩文件内！
FXBrowserOpVC:donotCopyZipToCloud	The file in the zip floder cannot be copied to the cloud directly.	압축 폴더안의 파일은\n클라우드에 바로 복사 할 수 없습니다.	压缩文件内的文件，不能直接复制到云盘。
FXBrowserOpVC:Copying	Copying...	복사 중...	正在复制……
FXBrowserOpVC:Moving	Moving...	이동 중...	正在移动……
FXBrowserOpVC:Deleting	Deleting...	삭제 중...	正在删除……
FXBrowserOpVC:Downloading	Downloading...	다운로드 중...	正在下载……
FXBrowserOpVC:lblDeleteContent	Do you want to delete the item?	항목을 삭제하시겠습니까?	要删除此项吗？
FXBrowserOpVC:lblFolder	Folder	폴더	文件夹
FXBrowserOpVC:lblFile	File	파일	文件
FXBrowserOpVC:lblCopy	Copy	복사	复制
FXBrowserOpVC:lblMove	Move	이동	移动
FXBrowserOpVC:lblDelete	Delete	삭제	删除
FXBrowserOpVC:lblSend	Share	공유	共享
FXBrowserOpVC:alreadyOpenFolder	Folder(subfolder) is already open.	해당 폴더 및 하위 폴더가 열려 있습니다.	相应文件夹或子文件夹已被打开！
FXBrowserOpVC:errorCopySubFolder	Cannot copy to subfolder.	하위 폴더에는 복사할 수 없습니다.	不能复制到子文件夹内！
FXBrowserOpVC:CompleteDelete	Delete Completed	삭제 완료	删除完成！
FXBrowserOpVC:CompleteCopy	Copy Completed	이동 완료	复制完成！
FXBrowserOpVC:CompleteMove	Move Completed	복사 완료	移动完成！
FXBrowserOpVC:donotMoveFromZip	Cannot move from ZIP folder	Zip 폴더 안에서 이동 할 수 없습니다.	不能在 Zip 文件夹内移动！
FXBrowserOpVC:donotDeleteFromZip	Cannot delete from ZIP folder	Zip 폴더 안에서 삭제 할 수 없습니다.	不能删除 Zip 文件夹内文件！
FXBrowserOpVC:donotDeleteInbox	Cannot delete inbox folder.	Inbox 폴더는 삭제 할 수 없습니다.	不能删除 Inbox 文件夹！
FXBrowserOpVC:donotMoveInbox	Cannot move inbox folder.	Inbox 폴더는 이동 할 수 없습니다.	不能移动 Inbox 文件夹！
FXBrowserOpVC:donotCopyInbox	Cannot copy inbox folder.	Inbox 폴더는 복사 할 수 없습니다.	不能复制 Inbox 文件夹！
FXBrowserOpVC:alertNetworkDisconnected	You are not connected to a network. Please check your internet \n connection or Wi-Fi setting.	서버 응답 오류(%d)	网络连接已断开！\n请在连接蜂窝移动数据或 Wi-Fi 后使用。
FXBrowserOpVC:alertNetworkError	You are not connected to a network. Please check your internet \n connection or Wi-Fi setting.	네트워크 연결이 꺼져 있습니다.\n셀룰러 데이터 또는 Wi-Fi 연결 후\n사용해 주세요.	请确认网络连接后，重试！
FXBrowserOpVC:notSupportFolder	Copying from the cloud is not supported.	네트워크 연결이 꺼져 있습니다.\n셀룰러 데이터 또는 Wi-Fi 연결 후\n사용해 주세요.	不支持复制云盘内文件夹！
FXBrowserOpVC:notSupportDownload	You must sync your files.	클라우드에서(로부터) 폴더 복사는 지원하지 않습니다.	您有需要同步的文件！
FXBrowserOpVC:alertDiskFull	Not enough memory.\nPlease clear some of your data first.	동기화가 필요한 파일이 존재합니다.	终端存储空间不足！\n请确保存储空间后，重试。
FXBrowserOpVC:WrongRequest	Server response error (%d).	단말 저장 공간이 부족합니다.\n저장 공간을 확보한 후\n다시 시도해 주세요.	服务器响应错误！ (%d)
FXBrowserOpVC:lblDownload	Download	다운로드	下载
FXBrowserOpVC:lblUpload	Upload	업로드	上传
FXBrowserOpVC:lblOnlyDownload	Only downloading from cloud is supported.	클라우드로부터 다운로드 기능만 제공 됩니다.	只提供从云盘下载的功能！
FXBrowserOpVC:alertUnknownError	An unknown error has occurred.	알 수 없는 오류가 발생하였습니다.	发生未知错误！
FXBrowserOpVC:Alert_NetworkDisconnected	You are not connected to a network. Please check your internet \n connection or Wi-Fi setting.	데이터에 접근하려면, \n에어플레인 모드를 해제해 주세요.	网络连接已断开！\n请在连接蜂窝移动数据或 Wi-Fi 后使用。
FXBrowserOpVC:Error_AIRPLANE	Please turn off airplane mode to access the data.	네트워크 연결이 꺼져 있습니다.\n셀룰러 데이터 또는 Wi-Fi 연결 후\n사용해 주세요.	要访问数据，请先解除飞行模式！
FXBrowserOpVC:lblMoveFolder	Choose Folder to move	이동할 경로를 선택하세요.	选择文件夹移动
FXBrowserOpVC:lblCopyFolder	Choose Folder to copy	복사할 경로를 선택하세요.	选择文件夹复制
FXBrowserOpVC:lblChooseFolder	Choose Folder	경로를 선택하세요	选择文件夹
FXBrowserOpVC:NoSync	You cannot overwrite a file that has not been synced	동기화 안된 파일은 덮어쓸 수 없습니다.	不同步的文件不能被覆盖
FXBrowserOpVC:FailedToDeleteShare	Failed to delete the document. Please try again later.	문서를 삭제하지 못했습니다. 잠시 후에 다시 시도하십시오.	无法删除该文件。请在几分钟后再试一次。
			
FXTabRecentVC:lockStr	Locked.	잠금 설정을 하였습니다.	已设置锁定！
FXTabRecentVC:unlockStr	Unlocked.	잠금 해제를 하였습니다.	已解除锁定！
FXTabRecentVC:maximumLimited	Up to\n25 files can be locked.	파일 잠금 설정은 최대\n25개까지 가능합니다.	最多可对 25 个文件设置锁定
FXTabRecentVC:aRenameText	The text entered exceeds the maximum length.	최대 길이를 초과하였습니다.	已超过最大长度！
FXTabRecentVC:specialCharacter	Special characters (\\, /, :, *, ?, \, “, <, >, and |)\ncannot be used.	특수문자 (\\ / : * ? \ “ < > |)는\n사용할 수 없습니다.	不能使用特殊字符 (\\ / : * ? \ “ < > |)
			
FXBrowserTable:lblEmpty	No item.	항목 없음	无项目
FXBrowserTable:Error_ONZIP	Zip file error.	압축 파일 오류	压缩文件错误！
FXBrowserTable:invalidTask	You do not have permission to access the document.	해당 문서에 접근 권한이 없습니다.	没有权限访问相应文件！
FXBrowserTable:NoSyncFile	Try again after synchronizing is complete.	동기화완료 후 다시 시도해주세요.	重试后同步完成。
			
FXBrowserTableVC:btnFunc_File	New	신규	新增
FXBrowserTableVC:btnFunc_ZIP	ZIP	도구	道具
FXBrowserTableVC:btnFunc_NewFolder	New	새 폴더	新建文件夹
FXBrowserTableVC:btnSort	Sort	정렬	排序
FXBrowserTableVC:sort0	Title Up	제목 오름	标题升序
FXBrowserTableVC:sort1	Title Down	제목 내림	标题降序
FXBrowserTableVC:sort2	Date Up	날짜 오름	日期升序
FXBrowserTableVC:sort3	Date Down	날짜 내림	日期降序
FXBrowserTableVC:sort4	Format Up	형식 오름	格式升序
FXBrowserTableVC:sort5	Format Down	형식 내림	格式降序
FXBrowserTableVC:rootFolder	This is the root folder.	최상위 폴더 입니다.	这是最上级文件夹！
FXBrowserTableVC:downloading	Downloading...	다운로드 중...	正在下载……
FXBrowserTableVC:Error_OPENZIP	Invalid zip file.	유효하지 않은 압축파일 입니다.	无效的压缩文件！
FXBrowserTableVC:Error_ONZIP	Zip file error	압축 파일 오류	压缩文件错误！
FXBrowserTableVC:Error_DoubleZIP	Compressing a file within a compressed file is not supported.	압축 파일안의 압축파일은 지원하지 않습니다.	不支持压缩文件内的压缩文件！
FXBrowserTableVC:alertNetworkError	Please check your network status,\n and try again.	네트워크 확인 후\n다시 시도해 주세요.	请确认网络后，重试！
FXBrowserTableVC:invalidTask	You have been logged out because your log in information has been lost.	로그인 정보가 유실되어 로그아웃되었습니다.	由于丢失了登录信息，因此已退出登录！
FXBrowserTableVC:WrongRequest	Server response error (%d).	서버 응답 오류(%d)	服务器响应错误！(%d)
FXBrowserTableVC:DeletedFile	The document does not exist. Please try again.	해당 문서가 존재하지 않습니다.\n 다시 한 번 확인해 주세요.	相应文件不存在！\n请重新确认。
FXBrowserTableVC:errorExtractDrive	Extracting this data is not supported.	해당 스토리지는 압축 해제를 지원하지 않습니다.	相应云盘不支持解压！
FXBrowserTableVC:Error_Editing	Please select the check box.	체크박스를 선택해 주세요.	请选择复选框！
FXBrowserTableVC:Error_Download	Download Failed	다운로드를 실패하였습니다.	下载失败！
FXBrowserTableVC:Recent	Recent Document	최근 문서	最近所用文件
FXBrowserTableVC:Shared	Shared Document	공유 문서	共享的文件
FXBrowserTableVC:invalidTask	You do not have permission to access this document.	해당 문서에 접근 권한이 없습니다.	没有权限访问相应文件！
FXBrowserTableVC:alertNetworkDisconnected	You are not connected to a network. Please check your internet \n connection or Wi-Fi setting.	네트워크 연결이 꺼져 있습니다.\n셀룰러 데이터 또는 Wi-Fi 연결 후\n사용해 주세요.	网络连接已断开！\n请在连接蜂窝移动数据或 Wi-Fi 后使用。
FXBrowserTableVC:taskError	You cannot access the service \n because the service is temporarily unavailable. \n Please try again later.	일시적인 서비스 장애로 접속이 원할하지 않습니다. 잠시 후 다시 시도해 주세요.	由于出现暂时的业务障碍，系统连接不畅通！请稍后重试。
FXBrowserTableVC:order.group	Group	그룹	组合
FXBrowserTableVC:order.time	Time	시간	时间
FXBrowserTableVC:saveLocation	Save to : My document %@	저장위치 : 내 문서 %@	存储位置 : 我的文档 %@
FXBrowserTableVC:NoSyncFile	Try again after synchronizing is complete.	동기화완료 후 다시 시도해주세요.	重试后同步完成。
FXBrowserTableVC:maxFileLength	File/Folder names can contain up to %d characters.	파일/폴더 이름은 %d자를 넘어갈 수 없습니다.	文件名称最多可包含 %d 个字符。
			
FXInformationVC:lblFileInfo	File Information	파일정보	文件信息
FXInformationVC:lblFolderInfo	Folder Information	폴더정보	文件夹信息
FXInformationVC:lblDetails	Details	상세정보	详细信息
FXInformationVC:lblShareInfo	Sharing Information	문서 공유 정보	文档共享信息
FXInformationVC:lblClose	Close	닫기	关闭
FXInformationVC:CompleteDelete	Delete Completed	삭제가 완료 되었습니다.	删除完成！
FXInformationVC:completeMail	Emailing Completed	메일 전달 완료.	邮件发送完成！
FXInformationVC:downloading	Downloading..	다운로드 중..	正在下载……
FXInformationVC:invalidTask	You do not have permission to access this document.	해당 문서에 접근 권한이 없습니다.	没有权限访问相应文件！
FXInformationVC:FailedToDeleteShare	Failed to delete the document. Please try again later.	문서를 삭제하지 못했습니다. 잠시 후에 다시 시도하십시오.	无法删除该文件。请在几分钟后再试一次。
FXInformationVC:NoSyncFile	Try again after synchronizing is complete.	동기화완료 후 다시 시도해주세요.	重试后同步完成。
			
FXInfoThumbVC:downloading	Downloading...	다운로드 중...	正在下载…….
FXInfoThumbVC:Error_AIRPLANE	To access the data,\nplease turn off Airplane mode.	데이터에 접근하려면, \n에어플레인 모드를 해제해 주세요.	要访问数据，请先解除飞行模式。
FXInfoThumbVC:Alert_NetworkDisconnected	You are not connected to a network. Please check your internet \n connection or Wi-Fi setting.	네트워크 연결이 꺼져 있습니다.\n셀룰러 데이터 또는 Wi-Fi 연결 후\n사용해 주세요.	网络连接已断开！\n请在连接蜂窝移动数据或 Wi-Fi 后使用。
FXInfoThumbVC:maxFileLength	File/Folder names can contain up to %d characters.	파일/폴더 이름은 %d자를 넘어갈 수 없습니다.	文件名称最多可包含 %d 个字符。
			
FXInfoTextVC:fileName	File Name	이름	文件名
FXInfoTextVC:extension	Type	종류	类型
FXInfoTextVC:path	Location	경로	路径
FXInfoTextVC:size	Size	용량	大小
FXInfoTextVC:folderCount	Folder Count	폴더	文件夹
FXInfoTextVC:fileCount	File Count	파일	文件
FXInfoTextVC:docTitle	Title	제목	标题
FXInfoTextVC:createUser	Creator	작성	创建
FXInfoTextVC:modifyUser	Last saved by	수정	修改
FXInfoTextVC:date_modify	Modified	날짜	日期
FXInfoTextVC:wordCount	Word Count	단어수	字数
FXInfoTextVC:folder	Folder	폴더	文件夹
FXInfoTextVC:btnEdit	Edit	편집	编辑
FXInfoTextVC:shared	Shared Document	공유 문서	共享的文件
FXInfoTextVC:myDocument	My Document	내 문서	我的文件
FXInfoTextVC:public	Public	공개	公开
FXInfoTextVC:private	Private	비공개	私人
			
FXInfoBtnVC:Share	Share	전달	传送
FXInfoBtnVC:Delete	Delete	삭제	删除
FXInfoBtnVC:lblFolderDelete	Do you want to delete this folder?	다음 폴더를 삭제하시겠습니까?	您要删除此文件夹吗？
FXInfoBtnVC:lblFileDelete	Do you want to delete this file?	다음 파일을 삭제하시겠습니까?	您要删除此文件吗？
FXInfoBtnVC:Send	Send	보내기	发送
FXInfoBtnVC:failedCreateWeblink	Link cannot be created. Please reconnect to the network and try it again.	네크워크가 연결되지 않아 링크를 생성할 수 없습니다.	没有连接网络，无法生成链接！
FXInfoBtnVC:sendWeblinkMailTitle	%@' document's link has been shared.	%@' 문서의 링크를 공유하였습니다.	已共享 \%@\" 文件链接！"
FXInfoBtnVC:sendWeblinkMailBody	%@<%@> has been shared '%@' document's link.\n\n%@\n\n\Polaris Office allows you to collaborate and work on your documents anytime and anywhere.\""	%@<%@>님이 '%@' 문서의 링크를 공유하였습니다.\n\n%@\n\n\Polaris Office를 통해 문서를 기반으로 동료와 커뮤니케이션하고 언제 어디서나 연속적인 문서 작업을 할 수 있습니다.\""	%@<%@> 共享了 \%@\" 文件链接。\n\n%@\n\n\"可通过 Polaris Office，围绕着所共享的文件，与同事进行沟通，并随时随地连续进行文档处理。\""
FXInfoBtnVC:sendWeblinkFacebook	Document has been shared in Polaris Office.	Polaris Office에서 문서를 공유하였습니다.	在 Polaris Office 共享了文件
FXInfoBtnVC:sendWeblinkTwitter	Document has been shared in Polaris Office.\n%@ %@	Polaris Office에서 문서를 공유하였습니다.\n%@ %@	在 Polaris Office 共享了文件\n%@ %@
FXInfoBtnVC:SNSNameTwitter	Twitter	트위터	Twitter
FXInfoBtnVC:SNSNameFacebook	Facebook	페이스북	Facebook
FXInfoBtnVC:SNSConfigureNeeded	Register %@ account\nand try it again.	%@ 계정 설정 후 다시 시도해주세요.	请设置 %@ 账户后，重试！
FXInfoBtnVC:error116	You are not authorized to access the document.	해당 문서에 접근 권한이\n없습니다.	没有权限访问相应文件！
FXInfoBtnVC:copyToClipboard	Copy to clipboard.	클립보드에 복사되었습니다.	已复制到剪贴板！
FXInfoBtnVC:Error_AIRPLANE	To access the data,\nplease turn off Airplane mode.	데이터에 접근하려면, \n에어플레인 모드를 해제해 주세요.	要访问数据，请先解除飞行模式。
FXInfoBtnVC:Alert_NetworkDisconnected	You are not connected to a network. Please check your internet \n connection or Wi-Fi setting.	네트워크 연결이 꺼져 있습니다.\n셀룰러 데이터 또는 Wi-Fi 연결 후\n사용해 주세요.	网络连接已断开！\n请在连接蜂窝移动数据或 Wi-Fi 后使用。
FXInfoBtnVC:share.kakao.msg	Document has been shared in Polaris Office.	Polaris Office에서 문서를 공유하였습니다.	在 Polaris Office 共享了文件
FXInfoBtnVC:share.line.msg	Document has been shared in Polaris Office.\n%@	Polaris Office에서 문서를 공유하였습니다.\n%@	在 Polaris Office 共享了文件\n%@
			
FXPopBrowserVC:btnClose	Close	닫기	关闭
			
FXRenameVC:newFolder	New Folder	새 폴더	新建文件夹
FXRenameVC:sameFolder	The folder with this name already exists in this folder.	동일한 폴더가 존재합니다.	已有相同文件夹！
FXRenameVC:sameFile	The file with this name already exists in this folder.	동일한 파일이 존재합니다.	已有相同文件！
FXRenameVC:errorCreateFolder	Cannot be created due to \n limitation of the system and cloud.	시스템 및 클라우드 제한으로\n생성할 수 없습니다.	由于系统和云盘限制，无法创建文件夹！
FXRenameVC:errorChangeName	Cannot be changed due to \n limitation of the system and cloud.	시스템 및 클라우드 제한으로\n변경할 수 없습니다.	由于系统和云盘限制，无法更改名称！
FXRenameVC:ChangeName	Change name	이름 변경	更改昵称
FXRenameVC:CreateFolder	Create Folder	폴더 생성	创建文件夹
FXRenameVC:Done	Done	완료	完成
FXRenameVC:Cancel	Cancel	취소	取消
FXRenameVC:aRenameText	The text entered exceeds the maximum length.	최대 길이를 초과하였습니다.	已超过最大长度！
FXRenameVC:specialCharacter	Special characters\n (\\, /, :, *, ?, \, “, <, >, and |)\ncannot be used.	특수문자\n (\\ / : * ? \ “ < > |)는\n사용할 수  없습니다.	不能使用特殊符号\n (\\ / : * ? \ “ < > |)
FXRenameVC:specialCharacterForWebDav	Special characters\n (\\, /, ., :, *, ?, \, “, <, >, and |)\ncannot be used.	특수문자\n (\\ / . : * ? \ “ < > |)는\n사용할 수  없습니다.	不能使用特殊符号\n (\\ / . : * ? \ “ < > |)
FXRenameVC:wrongName	\%@\" name cannot be used."	\%@\"이름은\n사용할 수 없습니다."	不能使用 \%@\" 名称！"
FXRenameVC:dotFileName	Cannot use a file name \n that begins with \.\"."	\.\"으로 시작하는 파일명을\n사용할 수 없습니다."	不能使用以 \.\" 开始的文件名！"
FXRenameVC:dotFolderName	Cannot use a folder name \n that begins with \.\"."	\.\"으로 시작하는 폴더명을\n사용할 수 없습니다."	不能使用以 \.\" 开始的文件夹名！"
FXRenameVC:maxLength	Cannot input the name due to exceeding maximum length.	이름이 너무 길어 입력할 수 없습니다.	名字过长，无法输入！
FXRenameVC:textCount	%d/%d	%d/%d	%d/%d
FXRenameVC:emptyText	No input value.	입력된 값이 없습니다.	没有输入的值！
FXRenameVC:WrongRequest	Invalid request.(%d)	잘못된 요청입니다.(%d)	错误的请求！(%d)
FXRenameVC:alertNotAddress	Incorrect server address.	Incorrect server address.	错误的服务器地址！
FXRenameVC:alertNetworkError	Please check your network status,\nand then try it again.	네트워크 확인 후\n다시 시도해 주세요.	请确认网络后，重试！
FXRenameVC:alertNetworkDisconnected	You are not connected to a network. Please check your internet \n connection or Wi-Fi setting.	네트워크 연결이 꺼져 있습니다.\n셀룰러 데이터 또는 Wi-Fi 연결 후\n사용해 주세요.	网络连接已断开！\n请在连接蜂窝移动数据或 Wi-Fi 后使用。
FXRenameVC:unknownError	Please sync My Documents and try again.	내문서 동기화 후 다시 시도해 주세요.	请同步我的文档后重试！
			
FXHomeVC:mailOpenAlert	A file is being edited\nin Polaris Office. Do you want to open the attachment\nwithout saving the file first?	문서 편집중입니다. 저장하지 않고\n새로운 문서를 여시겠습니까?	正在编辑文档，要放弃当前编辑的文档，而打开新文档吗？
FXHomeVC:mailOpenPop	Please close the pop-up window and try again.	팝업을 닫고 다시 시도해 주세요.	请关闭弹出框后重试！
FXHomeVC:mailOpenSlideShow	Finish slide show and try again.	슬라이드 쇼 종료 후 다시 시도해 주세요.	请结束幻灯片播放后重试！
FXHomeVC:mailOpenMailSend	Finish sending mail and try again.	메일 보내기 종료 후 다시 시도해 주세요.	请结束邮件发送后重试！
FXHomeVC:mailOpenCloudLogin	Finish logging out of cloud storage and try again.	스토리지 로그인 종료 후 다시 시도해 주세요.	请结束云盘登录后重试！
FXHomeVC:UnsupportFile	This file format is not supported.	지원하지 않는 파일 형식입니다.	不支持的文件格式！
FXHomeVC:Recovery Title	Auto Recovery	자동 복구	自动恢复
FXHomeVC:Recovery Contents	has been auto-recovered. Do you want to open the document?	자동 복구되었습니다. 해당 문서를 열어 보시겠습니까?	已自动恢复！要打开确认吗？
FXHomeVC:Delete	Delete	삭제	删除
FXHomeVC:Open	Open	열기	打开
FXHomeVC:Save	Save	저장	保存
FXHomeVC:Recovery	Recover	복구	恢复
FXHomeVC:screenConnect	The screen has been connected.	화면을 연결하였습니다.	已连接画面！
FXHomeVC:screenDisconnect	The screen has been disconnected.	화면이 해제되었습니다.	画面连接已断开！
FXHomeVC:invalidTask	You do not have permission to view the document.	해당 문서에 접근 권한이 없습니다.	没有权限访问相应文件！
FXHomeVC:bbibbo	Server is undergoing maintenance .\nPlease try again in a few minutes.	서버 점검중에 있습니다.\n잠시후 다시 시도해 주세요.	正在检查服务器，请稍候重试！
FXHomeVC:btnShowAgain	Do not show again	다시 보지 않기	不再显示
FXHomeVC:btnConfirm	Confirm	확인	确认
FXHomeVC:btnNoti	Notice	공지사항	公告
FXHomeVC:lblReview	Review Polaris Office’s word, spreadsheet, or presentation functions! Let us know how we’re doing!	Polaris Office의 리뷰를 남겨주세요!\n여러분의 소중한 의견은 Polaris\nOffice에 많은 도움이 됩니다.	请提出您对 Polaris Office 的宝贵意见！
FXHomeVC:btnReview	Write a Review	리뷰 남기기	撰写评论
FXHomeVC:btnCancel	Close	닫기	关闭
FXHomeVC:InvalidShareFormat	This file format is not support.	지원하지 않는 형식입니다.	不支持的文件格式
FXHomeVC:LinkError	The network is busy.\nPlease try it again later.	네트워크 상태가 원활하지 않습니다.\n잠시 후 다시 시도해 주세요.	网络状态不稳定，请稍后再试
FXHomeVC:premiumDesAboutRecent	Document opened from 'My Document' will also appear in 'Recent Document' menu.	내 문서 외 다른 저장소에 있는 문서는 최근 문서에 표시되지 않습니다.	我的文档'中已经打开过的文档，也会显示在'最近使用的文档'列表中。
FXHomeVC:chargelevel_coupon	Congratulations.\n\n%d months Premium Service coupon has been registered.\nExperience new Polaris Office available at iOS, Android, and desktop now!	축하합니다.\n\n프리미엄 서비스 %d개월 무료 이용권이 등록되었습니다.\niOS, Android 뿐만 아니라 PC에서도 이용 가능한 새로워진 Polaris Office 서비스를 지금 바로 경험해보세요!	祝贺您！\n\n高级账户服务 %d个月免费试用券已被登记。\n您现在就可以在 iOS、Android 设备，甚至在您的计算机上体验 Polaris Office 崭新的服务。
FXHomeVC:chargelevel_other_title	Thank You	감사합니다	感谢您升级到高级账户
FXHomeVC:chargelevel_other	You can now use Premium Service.\nExperience Polaris Office Premium service with more space from various devices.	지금부터 Premium 서비스를\n이용하실 수 있습니다.\n더욱 많은 용량으로 다양한 기기에서 \n Polaris Office Premium 서비스를\n맘껏 이용해 보세요.	现在开始您可以使用高级账户服务。\n您可以在更多存储空间和更多同步设备上尽情享用 Polaris Office 高级账户服务。
FXTabBrowserVC:PosTitle	Polaris Office Sync	Polaris Office Sync	Polaris Office Sync
FXTabBrowserVC:PosDesc	You can download Polaris Office Sync for  PCs to sync to other devices. Download Now!	Desktop용 Polaris Office Sync를 통해 동기화된 문서를 확인 할 수 있습니다. 지금 바로 다운로드 받으세요!	在计算机上使用 Polaris Office Sync 查看已同步的文档。马上下载试试吧！
FXHomeVC:PosBtn1	Polaris Office Sync Download	Polaris Office Sync 다운로드	下载 Polaris Office Sync
FXHomeVC:PosBtn2	View Later	나중에 다시 보기	下次再提示
FXHomeVC:PosBtn3	Do not show again	다시 보지 않기	不再显示
FXHomeVC:PosTitleThanks	Thank You!	감사합니다!	谢谢!
FXHomeVC:PosDescThanks	Thank you for installing Polaris Office Sync. As a thank you, we want give you an additional 300 MB of Polaris Office storage. Please rate us in the app stores!	Desktop 용 Polaris Office Sync를 설치해 주셔서 감사합니다. 감사의 뜻으로 300MB의 보너스 용량을 지급하였습니다. 기분 좋은 느낌을 리뷰로 남겨주세요!	感谢您使用 Polaris Office Sync。给您赠送 300MB 存储空间，以表达我们的谢意。请对我们撰写评论吧！
FXHomeVC:PosBtnReview	Write a Review	리뷰 달기	撰写评论
FXHomeVC:PosBtnClose	Close	닫기	关闭
FXHomeVC:UpgradeReward	Thank you for upgrading your account! You may now use premium features, such as additional storage, more devices you can connect and sync, and etc. Please rate us on App Store!	계정 업그레이드를 해주셔서 감사합니다. 추가 용량, 기기 추가 등 다양한 기능을 경험하실 수 있습니다. 기분 좋은 느낌을 리뷰로 남겨주세요!	感谢您升级到高级账户！现在您可以使用更多存储空间，在更多设备上进行同步。请您对我们撰写评论吧！
FXHomeVC:InviteJoinReward	Thank you for completing registration via invitation. As an appreciation, we'll give you an additional storage of 100MB! Please rate us on App Store!	초대를 통해 가입해 주셔서 감사합니다. 감사의 뜻으로 100MB의 보너스 용량이 지금되었습니다. 기분 좋은 느낌을 리뷰로 남겨주세요!	感谢您接受邀请并成为我们的会员！给您提供100MB奖励存储空间，以表达我们的谢意。请您对我们撰写评论吧！
FXHomeVC:InviterReward	Thank you for inviting a new user. As an appreciation, we'll give you an additional storage of 100MB! Please rate us on App Store!	초대를 통해 가입해 주셔서 감사합니다. 감사의 뜻으로 100MB의 보너스 용량이 지금되었습니다. 기분 좋은 느낌을 리뷰로 남겨주세요!	感谢您邀请新会员！给您提供100MB奖励存储空间，以表达我们的谢意。请您对我们撰写评论吧！
			
FXBrowserGuideVC:lblExplain	Move to the upper folder	상위 폴더로 이동됩니다.	将移动到上级文件夹
FXBrowserGuideVC:AgaingNotShow	Do not show again	다시 보지 않기	不再显示
FXBrowserGuideVC:Close	Close	닫기	关闭
			
FXInfoThumbVC:errorExtractDrive	Extracting the file is not supported.	해당 스토리지는 전체 압축해제를\n지원하지 않습니다.	相应云盘不支持全部解压！
			
UTextField:Cancel	Cancel	취소	取消
			
FXChangeDeviceVC:lblTitle.manage	Manage linked devices	연동 기기 관리	管理已连接设备
FXChangeDeviceVC:lblTitle.disconnect	Disconnect linked devices	연동 기기 해제	解除设备连接
FXChangeDeviceVC:btnDone	Done	완료	完成
FXChangeDeviceVC:btnPremium	Upgrade account	계정 업그레이드	升级账户
FXChangeDeviceVC:btnDisconnect	Disconnect linked devices	연동 기기 해제	解除设备连接
FXChangeDeviceVC:lblDescription	Upgrade your account to \nadd more devices or clear a device from your device list.	계정을 업그레이드하여 연동 기기를 \n추가하거나, 디바이스 관리를 눌러 \n다른 기기를 정리해 주세요.	请升级账户增加要连接的设备数量，或点击设备管理，对已连接设备进行整理。
FXChangeDeviceVC:lastAccessTime	Last Connection : %@	마지막 접속: %@	上次访问时间：%@
FXChangeDeviceVC:lastAccessTime.dateformat	yyyy/MM/dd HH:mm	yyyy/MM/dd HH:mm	yyyy/MM/dd HH:mm
FXChangeDeviceVC:disconnectDevice	Disconnecting the selected device:\n'[%@]'\nDo you want to continue?	선택한 ['%@']\n기기의 연결을 해제합니다.\n계속할까요?	将要解除已选中的 [%@] 连接，要继续吗？
FXChangeDeviceVC:disconnectDeviceFail	Fail to disconnect device	디바이스 연결 해제에 실패하였습니다.	设备连接解除失败！
			
FXCapacityAlertVC:lblExceed	Your storage is full.	용량이 초과되었습니다.	已超过容量！
FXCapacityAlertVC:lblLowCapacity	%.1fMB storage capacity is remaining	저장 용량이 %.1fMB 남았습니다.	剩余存储容量为 %.1fMB！
FXCapacityAlertVC:lblOverStorage	Premium service period has expired. Saved documents will be deleted on %@ because you've exceeded the maximum storage limit as a free subscriber.	프리미엄 서비스 기간이 만료되었습니다. 용량이 초과되어 %@에 저장된 문서가 초기화 됩니다.	高级账户期限已到期，由于已经超过容量，保存到 %@ 的文件将被初始化。
FXCapacityAlertVC:lblExpirePremium	Premium service period has expired. Upgrade your account if you wish to use Premium Service.	프리미엄 서비스 기간이 만료되었습니다. 프리미엄 서비스 사용을 원하시면 업그레이드를 해주세요.	高级账户服务已到期。如需继续使用，请对您的账户进行升级！
FXCapacityAlertVC:btnUpgrade	Upgrade account	계정 업그레이드	升级账户
FXCapacityAlertVC:lblExtend	Cannot synchronize. detail	동기화를 할 수 없습니다.  자세히 보기	无法进行同步！查看详情
FXCapacityAlertVC:btnMoreStorage	Get More Storage	더 많은 용량 얻기	获得更多容量
FXCapacityAlertVC:lblUnverified	Please complete the e-mail authentication process.	이메일 인증을 해주세요.	请完成电子邮箱认证！
FXCapacityAlertVC:lblUnverifiedFull	Please complete the e-mail verification to start using our service.	원활한 서비스 이용을 위해 이메일 인증을 해주세요.	请完成电子邮箱认证，已确保整单使用业务。
FXCapacityAlertVC:lblUnverifieInvitedFull	Please complete the e-mail verification and earn 100MB bonus space.	인증 메일을 확인해 주세요. 이메일 인증을 완료하시면 100MB의 보너스 용량이 제공됩니다.	完成邮箱地址的认证，即可获得 100MB 奖励空间。重发邮件
FXCapacityAlertVC:btnEmailValidate	Verify	인증하기	认证
FXCapacityAlertVC:sendValidateEmail	A verification e-mail has been sent.	이메일 인증을 위한 메일을 발송하였습니다.	已发送电子邮箱认证邮件！
FXCapacityAlertVC:btnPasswordSetup	Set Password	비밀번호 설정	设置密码
FXCapacityAlertVC:lblPasswordSetup	Please set a password	비밀번호를 설정해 주세요	请设置密码
FXCapacityAlertVC:lblPasswordSetupFull	This account does not have a password. Please set the password to login online and on your other devices.	계정에 비밀번호가 설정되어 있지 않습니다. 다른 기기와 Web에서도 로그인할 수 있도록 비밀번호를 설정해 주세요.	您的账户尚未设置密码。请设置密码，以便在其他设备或网站也能进行登录。
			
FXCloudBoxVC:cellGoogle	Google Drive	Google Drive	Google Drive
FXCloudBoxVC:cellBoxnet	Box.net	Box.net	Box.net
FXCloudBoxVC:cellDropbox	Dropbox	Dropbox	Dropbox
FXCloudBoxVC:cellWebDAV	WebDAV	WebDAV	WebDAV
FXCloudBoxVC:cellSugarSync	Sugar Sync	Sugar Sync	Sugar Sync
FXCloudBoxVC:cellUcloud	ucloud	ucloud	ucloud
FXCloudBoxVC:cellSkyDrive	OneDrive	OneDrive	OneDrive
FXCloudBoxVC:cellHuddle	Huddle	Huddle	Huddle
FXCloudBoxVC:cellDocomo	Docomo	Docomo	Docomo
FXCloudBoxVC:Error_ONZIP	Zip file error.	압축 파일 오류	压缩文件错误！
FXCloudBoxVC:Error_DoubleZIP	Compressing a file within a compressed file is not supported.	압축 파일안의 압축파일은 지원하지 않습니다.	不支持压缩文件内的压缩文件！
FXCloudBoxVC:alertAuthenticationError	The e-mail address/password\nis not valid. Please enter again.	유효하지 않은 이메일 또는\n비밀번호입니다. 다시 시도해 주세요.	无效的电子邮箱地址或密码！请重试！
FXCloudBoxVC:alertDuple	The account %@ already exists.	%@' 계정이 존재합니다.	\%@\" 账户已存在！"
FXCloudBoxVC:alertNetworkError	Please check your network status,\nand then try it again.	네트워크 확인 후\n다시 시도해 주세요.	请确认网络后，重试！
FXCloudBoxVC:btnAddCloud	Add Cloud	클라우드 추가	添加云盘
FXCloudBoxVC:btnEditCloud	Edit Cloud	클라우드 편집	编辑云盘
FXCloudBoxVC:btnEditDoneCloud	Done	완료	完成
FXCloudBoxVC:Error_AIRPLANE	Please turn off Airplane mode to access the data.	데이터에 접근하려면, \n에어플레인 모드를 해제해 주세요.	要访问数据，请先解除飞行模式。
FXCloudBoxVC:alertNetworkDisconnected	You are not connected to a network. Please check your internet \nconnection or Wi-Fi setting.	네트워크 연결이 꺼져 있습니다.\n셀룰러 데이터 또는 Wi-Fi 연결 후\n사용해 주세요.	网络连接已断开！\n请在连接蜂窝移动数据或 Wi-Fi 后使用。
FXCloudBoxVC:alert3G	Not using a Wi-Fi to download the content may incur additional data charges.	Wi-Fi가 아닌 셀룰러 데이터를 이용하여\n연결 시 별도의 데이터 통화료가\n부과 될 수 있습니다.	使用蜂窝数据连接时，可能会产生额外的通信费用！
FXCloudBoxVC:WrongRequest	Server response error (%d).	서버 응답 오류(%d)	服务器响应错误！(%d)
FXCloudBoxVC:DeletedFile	Such document doesn't exist. Please check.	해당 문서가 존재하지 않습니다.\n 다시 한 번 확인해 주세요.	相应文件不存在！\n请重新确认！
FXCloudBoxVC:lblCloud	Add Cloud	가져오기 추가	添加获取
FXCloudBoxVC:lblTitle	Other Storage //Do not touch me!!!!	외부 저장소	外部存储
FXCloudBoxVC:lblTitleFree	Import	가져오기	获取
FXCloudBoxVC:btnEdit_edit	Edit	관리	管理
FXCloudBoxVC:btnEdit_done	Done	완료	完成
FXCloudBoxVC:deleteCloud	%@ is deleted	%@을(를) 삭제하였습니다.	已删除 %@！
FXCloudBoxVC:alertHelpFree	If you upgrade to Premium account,\nsaved document is automatically\nsaved in origin path.	Premium계정으로 전환하시면 편집한\n문서를 경로 변경 없이 바로\n저장할 수 있습니다.	升级到高级服务账户时，可以把完成编辑的文档直接保存到原位置。
FXCloudBoxVC:alertHelpPremium	You can view and edit document of external storage.	외부 저장소의 문서를 편집하고 바로 저장할 수 있습니다.	编辑外部存储空间的文档后，可直接进行保存。
FXCloudBoxVC:alertTitlePremium	Premium Service	Premium 서비스 사용중	业务介绍
			
FXAlarmVC:messageShared	%@ shared %@.	%@ 님이 %@ 을(를) 공유하였습니다.	%@ 共享了 %@
FXAlarmVC:messageComment	%@ wrote message of \%@\" on %@."	%@ 님이 %@ 에 \%@\" 코멘트를 작성하였습니다"	%@ 对 %@ 填写备注 \%@\""
FXAlarmVC:alertMessage	Synchronizing is required to open the shared document.	공유탭에서 동기화가 필요합니다.	共享标签中需要同步！
FXAlarmVC:downloadMessage	Downloading is required to open the shared document.	공유탭에서 다운로드가 필요합니다.	共享标签中需要下载！
FXAlarmVC:Done	Done	확인	确认
FXAlarmVC:downloading	Downloading...	다운로드 중...	正在下载…….
			
FXNewDocumentVC:Title	New Document	새 문서 만들기	新建空文件
FXNewDocumentVC:SubTitle	Start a draft of a document on a mobile device and edit it on a PC.	모바일에서 간단하게 작성하고 PC로 마무리 하세요.	在手机或平板电脑上新建简单文档后，在 PC 上完成文档内容。
FXNewDocumentVC:Blank	Blank Document	빈 문서	空文件
FXNewDocumentVC:Document	Word Template	워드 서식	文档样式
FXNewDocumentVC:Sheet	Sheet Template	시트 서식	电子表格样式
FXNewDocumentVC:Slide	Slide Template	슬라이드 서식	幻灯片样式
			
FXLinkBoxVC:btnNewDoc	New Document	새 문서 만들기	新建文件
FXLinkBoxVC:btnMyDoc	My Document	내 문서	我的文件
FXLinkBoxVC:btnRecent	Recent Document	최근 문서	最近所用文件
FXLinkBoxVC:btnShare	Shared Document	공유 문서	共享的文件
FXLinkBoxVC:lblTitle	My Storage //Do not touch me!!!!	내 저장소	我的存档箱
			
FXCapacityInfoVC:lblCapacity	%.1fMB in use	%.1fMB 사용 중	已使用 %.1fMB
FXCapacityInfoVC:lblCapacityGB	%@GB in use	%@GB 사용 중	已使用%@GB
FXCapacityInfoVC:lblDeviceCount	%d device(s) in use	%d대의 기기에서 사용 중	已在 %d 台设备中使用
			
FXServicePremiumVC:title	Premium Service	서비스 소개	业务介绍
FXServicePremiumVC:btnClose	Close	닫기	关闭
FXServicePremiumVC:purchaseBlue	Check out the upgraded version of Polaris Office!?	Polaris Office의 업그레이드 버전을 만나 보세요! 	请尝试 Polaris Office 升级版！
FXServicePremiumVC:purchaseBlack	Various features are added to enrich your experience using our application.	다양한 기능을 통해 더욱 풍부한 서비스를 경험하실 수 있습니다.	通过多个功能，能体验更丰富的业务。
FXServicePremiumVC:purchaseGray	Please select the monthly or yearly subscription.	월간 이용권과 연간 이용권 중 선택해 주세요.	请在月使用券和年使用券中进行选择！
FXServicePremiumVC:purchase1month	1 month	1개월	1 个月
FXServicePremiumVC:purchase1year	12 months	12개월	12 个月
FXServicePremiumVC:benefit	Premium Benefits	프리미엄의 혜택	付费业务优惠
FXServicePremiumVC:benefitTitle1	5GB of storage	5GB의 저장 공간	5GB 的存储空间
FXServicePremiumVC:benefitTitle2	Connect up to 5 devices	5대의 기기에서 사용	可在 5 台设备使用
FXServicePremiumVC:benefitTitle3	Supports a Variety of Storages	다양한 스토리지 저장 지원	支持更多存储方式
FXServicePremiumVC:benefitTitle4	Set passcode	앱 비밀번호 설정	设置应用密码
FXServicePremiumVC:benefitSub1	Upload more documents \n (50 times bigger storage than a free account)	더 많은 문서를\n마음껏 업로드 할 수 있습니다.\n(무료 계정의 약 50배)	您可以随意上传更多文件。\n(免费账户的 50 倍)
FXServicePremiumVC:benefitSub2	Sync up to 5 devices (Free accounts can connect up to 2 devices)	최대 5대의 기기에서 자유롭게\n문서를 이용하실 수 있습니다.\n(무료 2대 기기 사용 가능)	最多可在 5 台设备上自由查看和编辑文件。\n(免费账户能使用 2 台设备)
FXServicePremiumVC:benefitSub3	You can save imported documents directly to the source location	다양한 스토리지에서 불러온 문서를\n스토리지 원본 위치에\n바로 저정해 보세요.	您编辑过的文件，可以直接保存到原位置。
FXServicePremiumVC:benefitSub4	Set an app passcode to protect your documents	내 문서를 보호해줄\n앱 비밀번호를 설정해 보세요.	可设置保护文件的密码。
FXServicePremiumVC:premiumPurchase1	Premium Service	Premium 서비스	高级服务
FXServicePremiumVC:premiumPurchase2	Purchase	결제하기	支付
FXServicePremiumVC:purchaseDescription1	Upgrade Your Account	Polaris Office 계정을 업그레이드 해보세요.	请试试升级 Polaris Office 账户。
FXServicePremiumVC:purchaseDescription2	Explore premium features by upgrading your account.	업그레이드 된 기능을 통해 더욱 풍부한 서비스를\n경험하실 수 있습니다.	通过被升级的功能，可体验更加丰富的功能及服务。
FXServicePremiumVC:purchaseDescription2_p	Explore premium features by upgrading your account.	업그레이드 된 기능을 통해 더욱 풍부한 서비스를 경험하실 수 있습니다.	通过被升级的功能，可体验更加丰富的业务
FXServicePremiumVC:purchaseDescription2~phone	Explore premium features by upgrading your account.	업그레이드 된 기능을 통해\n더욱 풍부한 서비스를 경험하실 수 있습니다.	通过被升级的功能，可体验更加丰富的业务。
FXServicePremiumVC:discountDescription	* Discounts will be applied to subscription during sale events.	* 할인 이벤트 기간동안 결제 금액이 할인됩니다.	* 促销期间，江湖打折支付金额。
FXServicePremiumVC:monthPeriod	Monthly	매월	每月
FXServicePremiumVC:yearPeriod	Annual	매년	每年
FXServicePremiumVC:monthOriginPrice	3.99	3.99	3.99
FXServicePremiumVC:yearOriginPrice	39.99	39.99	39.99
FXServicePremiumVC:already_purchased	Payment made for this account.	이미 결제된 계정입니다.	已支付的账户！
FXServicePremiumVC:success_purchase	Payment completed.	결제가 완료되었습니다.	已完成支付！
FXServicePremiumVC:success_restore	Payment information has been restored.	결제 정보가 복원 되었습니다.	已恢复支付信息。
FXServicePremiumVC:failed_restore	Failed to retrieve.	복원 실패	恢复失败！
FXServicePremiumVC:btnRestore	Retrieve Payment	결제 정보 복원	恢复支付信息
FXServicePremiumVC:btnRestore~phone	Retrieve	복원	恢复
FXServicePremiumVC:lockAnotherdevice	Payment is in progress using another device.\n\nDevice name : %@\n Payment time : %@\n\nDo you want to continue on this device?	현재 다른 디바이스에서\n결제 진행 중입니다.\n\n디바이스명 : %@\n결제 진행 시간 : %@\n\n현재 디바이스에서\n결제를 진행하시겠습니까?	在其他设备上正在进行支付操作！\n\n设备名称：%@\n支付时间：%@\n\n要在当前设备上进行支付吗？
FXServicePremiumVC:failedProductInfo	Failed to bring Product information.	Product 정보를 가져오는데 실패하였습니다.	产品信息获取失败！
FXServicePremiumVC:failedPurchase	Purchase failed.	결제를 실패하였습니다.	支付失败！
FXServicePremiumVC:servererror_end_auto_subscription	This receipt is expired for subscription.	구독이 만료된 영수증 입니다.	订购期限到期的收据！
FXServicePremiumVC:servererror_cancel_purchase	Payment has been cancelled.	결제가 취소되었습니다.	支付被取消！
FXServicePremiumVC:servererror_receipt	Receipt error.	영수증 오류 입니다.	收据错误！
FXServicePremiumVC:servererror_purchaseServer	Error occured in the payment server.	결제 서버의 오류입니다.	支付服务器错误！
FXServicePremiumVC:servererror_duplicatepurchase	Duplicate purchase.	중복 결제입니다.	重复支付！
FXServicePremiumVC:servererror_nopurchasehistory	Payment history does not exist.	결제 히스토리 정보가 존재하지 않습니다.	没有支付记录信息！
FXServicePremiumVC:NetworkError	The network is busy.	네트워크 상태가 원활하지 않습니다.	网络状态不稳定！
FXServicePremiumVC:Alert_NetworkDisconnected	You are not connected to a network. Please check your internet \n connection or Wi-Fi setting.	네트워크 연결이 꺼져 있습니다.\n셀룰러 데이터 또는 Wi-Fi 연결 후\n사용해 주세요.	网络连接已断开！\n请在连接蜂窝移动数据或 Wi-Fi 后使用。
FXServicePremiumVC:Error_AIRPLANE	Please turn off the Airplane mode to access the data.	데이터에 접근하려면, \n에어플레인 모드를 해제해 주세요.	要访问数据，请先解除飞行模式。
FXServicePremiumVC:benefitPoint1	5GB	5GB	5GB
FXServicePremiumVC:benefitPoint2	5 devices	5대	5台
FXServicePremiumVC:benefitPoint3	Variety of Storages	스토리지 저장	支持更多存储方式
FXServicePremiumVC:benefitPoint4	Set passcode	앱 비밀번호	设置应用密码
			
FXLoginVC:lblPolarisLogin	Welcome!	환영합니다!	欢迎您！
FXLoginVC:lblPolarisID	Email	이메일	账户
FXLoginVC:lblPolarisPW	Password	비밀번호	密码
FXLoginVC:lblPolarisIDHolder	Required	필요함	必填
FXLoginVC:lblPolarisPWHolder	Required	필요함	必填
FXLoginVC:btnLogin	Sign In	로그인	登录
FXLoginVC:btnLogout	Sign Out	로그아웃	退出
FXLoginVC:lblLoginText	You can easily create, edit and share documents\nwhen you login in.	로그인 한번으로 모든 기기에서\n문서를 자유롭게 확인할 수 있습니다	一次登录，即可在所有设备上自由查看文档。
FXLoginVC:alertLoginTitle	Notification	알림	通知
FXLoginVC:alertLoginOK	You are now logged on Polaris Office	Polaris Office 로그인이 되었습니다.	已登录 Polaris Office
FXLoginVC:alertLogoutOK	You are now logged out from Polaris Office	Polaris Office 로그아웃이 되었습니다.	已退出 Polaris Office 登录
FXLoginVC:alertLoginFail	This e-mail is not registered, or the e-mail address / password you entered is incorrect.	등록되지 않은 이메일이거나, 이메일 또는 비밀번호를 잘못 입력하였습니다.	未注册的电子邮箱地址，或电子邮箱地址或密码输入错误！
FXLoginVC:btnFind	Find Password	비밀번호 찾기	找回密码
FXLoginVC:btnPremium	Check Upgrade Service	업그레이드 서비스 확인	确认服务升级
FXLoginVC:btnClean	Manage Connected Devices	연결 기기 정리	管理已连接的设备
FXLoginVC:error_networkDisconnected	Please check your network connection.	네트워크 연결을 확인하시기 바랍니다.	请确认网络连接！
FXLoginVC:error_devicesExceeded	You cannot sign in with this device\nbecause you are already using the maximum number of devices connected to the application.	등록 가능한 기기를 초과하여\n로그인 할 수 없습니다.	已超过可注册的设备数量，而无法正常登录！
FXLoginVC:error_authentication7	This account is not verified yet. To use the service continually, you must first verify your account. Press OK to send a verification code to %@.  You can click the link included in the e-mail to finish registering your account for the Polaris Office.	인증되지 않은 계정입니다. 서비스를 이용하려면 계정 인증을 완료해야 합니다. 확인 버튼을 누르면 %@(으)로 메일을 보냅니다. 이메일에 제공된 링크를 클릭해야 Polaris Office 서비스 계정 만들기가 완료됩니다.	尚未认证的账户！您完成账户认证，才能正常使用服务。点击确认按钮时向 %@ 发送邮件。点击所收到的电子邮件内的链接后，才能完成 Polaris Office 服务账户创建。
FXLoginVC:alertPreventPasswd8	You have entered an incorrect password\n%d consecutive times.\nIf you enter an incorrect password 10 consecutive times,\nthen you have to reset your password.	비밀번호를 연속으로 %d회\n 잘못 입력하였습니다.\n연속으로 10회 잘못 입력할 경우 \n비밀번호를 재설정해야 합니다.	已连续 %d 次错误输入密码！\n连续错误输入 10 次后，需要重设密码。
FXLoginVC:alertPreventPasswd10	You have entered an incorrect password\n10 consecutive times.\nPlease reset your password.	비밀번호를 연속으로 \n10회 잘못 입력하였습니다.\n비밀번호를 재설정 해 주세요.	密码连续错误输入 10 次！\n请重设密码。
FXLoginVC:alertDeletedAccount	This account has already been deleted. To reuse this username, please wait 7 days.	이미 탈퇴한 계정입니다.\n 이 계정은 탈퇴 7일 이후에 \n 사용할실 수 있습니다.	已注销服务的用户名，注销 7 日后可以重新使用。
FXLoginVC:btnBack	Sign In	로그인	登录
FXLoginVC:btnCancel	Sign In	로그인	登录
FXLoginVC:lblTitle.FindPW	Find Password	비밀번호 찾기	找回密码
FXLoginVC:lblBody	Please enter your e-mail address to receive a password to reset the account.\n If you do not receive this e-mail in a few minutes, please press \Resend\".\n Please check your spam mail folder before resending the request."	비밀번호 재설정을 위해 Polaris Office 계정의 이메일 주소를 입력해 주시면 \n 안내 메일을 보내드립니다.	请输入 Polaris Office 账户的电子邮箱地址，系统向所输入的电子邮箱发送重设密码向导邮件。
FXLoginVC:lblBody.phone	Please enter your e-mail address to receive a password to reset the account.\n If you do not receive this e-mail in a few minutes, please press \Resend\".\n Please check your spam mail folder before resending the request."	비밀번호 재설정을 위해 Polaris Office 계정의 이메일 주소를 입력해 주시면 \n 안내 메일을 보내드립니다.	请输入 Polaris Office \n账户的电子邮箱地址，\n系统向所输入的电子邮箱\n发送重设密码向导邮件。
FXLoginVC:lblSubTitle	Did you forget your password?	비밀번호를 잊으셨나요?	忘记密码了？
FXLoginVC:btnCommit	Send	보내기	发送
FXLoginVC:lblEmail	E-mail	이메일	电子邮件
FXLoginVC:tfEmail.placeholder	Enter E-mail	E-mail 입력	输入电子邮箱地址
FXLoginVC:error_emptyEmail	Please enter an e-mail address.	E-mail을 입력하셔야 합니다.	需要输入电子邮箱地址
FXLoginVC:toastFindPassword	Your password has been sent to\n %@.	%@'로\n 메일이 전송되었습니다.	已向 %@ 发送邮件！
FXLoginVC:112again	The account verification e-mail is already sent.	계정 인증 email이 이미 발송되었습니다.	已发送账户认证邮件！
FXLoginVC:wrongName	The name \%@\", Cannot be used."	\%@\"이름은\n사용할 수 없습니다."	不能使用\%@\"名称！"
FXLoginVC:lblTitle.Join	Sign up	회원 가입	注册会员
FXLoginVC:lblMemberJoin	Sign up	회원 가입	注册会员
FXLoginVC:lblSecName	Last name	성	姓
FXLoginVC:lblFirstName	First Name	이름	名
FXLoginVC:lblID	Email	이메일	账户
FXLoginVC:lblPW	Password	비밀번호	密码
FXLoginVC:lblPWCheck	Confirm PW	비밀번호 확인	确认密码
FXLoginVC:tfSecName	Polaris	Polaris	Polaris
FXLoginVC:tfNeeded	Required	필요함	必填
FXLoginVC:tfOptional	Optional	선택사항	可选
FXLoginVC:tfID	example@mail.com	example@mail.com	example@mail.com
FXLoginVC:wvAgree	I agree to Polaris Office <a href=\https://www.Polarisoffice.com/view/rules\">Terms of Service</a> and <a href=\"https://www.Polarisoffice.com/view/privacy\">Privacy policy</a>."	Polaris Office의 <a href=\https://www.Polarisoffice.com/view/rules\">이용약관</a>과 <a href=\"https://www.Polarisoffice.com/view/privacy\">개인정보 수집 및 이용</a>에 동의합니다."	我同意 Polaris Office 的<a href=\https://link.Polarisoffice.com/view/rules\">服务条款</a>和<a href=\"https://link.Polarisoffice.com/view/privacy\">隐私政策</a>。"
FXLoginVC:lblShowPW	Show Password	비밀번호 표시	显示密码
FXLoginVC:lblJoin	Sign up	가입하기	注册
FXLoginVC:alertJoinTitle	Notification	알림	通知
FXLoginVC:alertJoinOK	Thank you for Signing Up!	가입이 완료되었습니다.	注册完成！
FXLoginVC:alertJoinFail	Error occured during the registration process.	가입 중 오류가 발생했습니다.	注册过程中发生错误！
FXLoginVC:alertPreventFirstName	Last name cannot contain special characters or numbers.	성에 특수문자나 숫자는\n입력할 수 없습니다.	姓不能输入特殊字符或数字！
FXLoginVC:alertPreventLastName	First name cannot contain special characters or numbers.	이름에 특수문자나 숫자는\n입력할 수 없습니다.	名不能输入特殊字符或数字！
FXLoginVC:alertPreventEmail	Please enter your e-mail address in the correct format.	이메일 형식으로\n입력해 주세요.	请以电子邮箱地址格式输入！
FXLoginVC:alertPreventPassword	Password must consist of 4 to 20 English letters and numbers.	비밀번호는 영문과 숫자를 혼용하여\n4~20자로 입력해 주세요.	密码需要包含 4~20 个英文字符和数字！
FXLoginVC:alertPreventMaxLength	Any entered string that exceeds the maximum length will be cut off.	최대 길이 이상 입력 시\n더 이상 입력되지 않습니다.	超过最大长度的部分不会被输入！
FXLoginVC:alertPreventPasswd	Password must consist of English letters and numbers.	비밀번호는 영문과 숫자를\n혼용하여 입력해 주세요.	密码请混合输入英文字符和数字！
FXLoginVC:alertPreventSamePasswd	Please check your password and enter it again.	비밀번호 확인 후\n다시 입력해 주세요.	确认密码后请重新输入！
FXLoginVC:alertExistEmail	This ID is already registered.\n Please try signing in.	이미 가입된 계정입니다.\n로그인으로 해주세요.	已注册过的账户！\n请直接登录。
FXLoginVC:Login	// Logging in...	// 로그인 중입니다.	// 正在登录
FXLoginVC:Wait	Please wait...	잠시 기다려 주십시오	请稍等！
FXLoginVC:btnUnderJoin	Do you already have an account? Sign In!	이미 계정이 있으신가요?	您已经有账户吗？
FXLoginVC:alertJoinAgree	Please agree to the terms of service.	서비스 약관에 동의하세요.	请同意使用条款！
FXLoginVC:lblJoinPWShow	Show	표시	显示
FXLoginVC:lblJoinPWHide	Hide	숨기기	隐藏
FXLoginVC:Confirm	Verifying...	인증중	正在认证...
FXLoginVC:lblTitle.Merge	Merge account	계정 통합(%@)	合并账户
FXLoginVC:lblMerge	Merge	통합하기	合并
FXLoginVC:PopAlert.FailLogin	Failed to sign in with Facebook	Facebook 로그인 실패	Facebook 登录失败！
FXLoginVC:PopAlert.DeniedLogin	Failed to connect to FaceBook account. \n Please allow access permission under your Facebook account settings.	Facebook 연결이 실패하였습니다.\n사용자의 Facebook 계정에서 접근 권한을 허용해 주십시오.	Facebook的连接失败。\n 您的Facebook帐户，以允许访问它。
FXLoginVC:PopAlert.CancelText	Done	확인	确认
FXLoginVC:btnFBLogin	Sign in with Facebook	Facebook으로 로그인	使用 Facebook 账户登录
FXLoginVC:btnFBJoin	Sign up with Facebook	Facebook으로 가입	使用 Facebook 账户注册
FXLoginVC:nameTitle	Name	이름	名
FXLoginVC:lblLine	OR	또는	或
FXLoginVC:PopAlert.errorFacebookEmail	You cannot create new account because the email is not registered in your facebook account.	Facebook 계정에 이메일이 등록되지 않아 회원 가입을 할 수 없습니다.	发送电子邮件的Facebook帐户没有注册，则不能注册。
FXLoginVC:lblFBGuide.Merge	Sign Up using Facebook account to create Polaris Office account. \n Please create a password for Polaris Office.	기존 Polaris Office 계정을 Facebook과 통합합니다.\nPolaris Office 계정 비밀번호를 입력해주세요.	这将编译的Facebook到目前的Polaris Office帐户。 \n 请将输入密码。
FXLoginVC:lblFBGuide.Join	Sign Up using Facebook account to create Polaris Office account. \n Please create a password for Polaris Office.	Facebook으로 Polaris Office를 시작합니다.\nPolaris Office 계정에 사용할 비밀번호를 입력해주세요.	启动Polaris Office被Facebook。 \ n请将输入密码从Polaris Office帐户才能使用。
FXLoginVC:lblTitle.FBJoin	Sign Up(%@)	회원 가입(%@)	注册会员(%@)
FXLoginVC:PopAlert.errorUserInfo	Failed to bring the information from Facebook.	Facebook 정보를 받아오는데 실패하였습니다.	无法使Facebook的信息。
			
FXPLoginVC:lblLoginTitle	Sign In	로그인	登录
FXPLoginVC:email	Email	이메일	电子邮件
FXPLoginVC:password	Password	비밀번호	密码
FXPLoginVC:findPassword	Find Password	비밀번호 찾기	找回密码
			
FXPopCoworkAttendee:lblTitle	Share	공유자	共享人
FXPopCoworkAttendee:lblOwnerTitle	Owner	소유자	所有人
FXPopCoworkAttendee:lblAttendeeTitle	Collaborator	공동 작업자	协作人
FXPopCoworkAttendee:lblAttendeeTitle2	Collaborator (%d)	공동 작업자 (%d)	协作人 (%d)
FXPopCoworkAttendee:lblTitleDocCast	Attendee	참여자	参与人
FXPopCoworkAttendee:lblOwnerTitleDocCast	Owner	주관자	主持人
FXPopCoworkAttendee:lblAttendeeTitleDocCast	Owner	참석자	出席人
FXPopCoworkAttendee:lblAttendeeTitleDocCast2	Owner (%d)	참석자 (%d)	出席人 (%d)
FXPopCoworkAttendee:lblIsPublic.on	Public	공개	公开
FXPopCoworkAttendee:lblIsPublicDesc.on	Anyone can view	회원 여부와 관계없이 문서 보기 가능	不管注册与否，均可查看文档
FXPopCoworkAttendee:lblIsPublic.off	Private	비공개	私人
FXPopCoworkAttendee:lblIsPublicDesc.off	Only the users who were invited can view	초대 받은 계정으로만 문서 보기 가능	只有被邀请的账户才能查看文档
FXPopCoworkAttendee:failedRequestAttendee	Failed to request the attendee's list information.	참여자 목록 정보 요청에 실패하였습니다.	参与人列表请求失败！
FXPopCoworkAttendee:failedDeleteAttendee	Failed to delete collaborator	공동 작업자 삭제를 실패했습니다.	协作人删除失败！
FXPopCoworkAttendee:taskStopped	This document is no longer shared with '%@'.	%@'님과 문서 공유가 중단되었습니다.	与\%@\"的共享已被中断！"
FXPopCoworkAttendee:failedRequestAttendee	Failed to request the participant's information.	참여자 목록 정보 요청에 실패하였습니다.	参与人列表请求失败！
			
FXPopCoworkContact:lblTitle	Address Book	주소록	通讯录
FXPopCoworkContact:lblShare	Share	공유하기	共享
FXPopCoworkContact:btnContact	Address Book	주소록	通讯录
FXPopCoworkContact:btnRecent	Recent	최근 발신	最近发送
FXPopCoworkContact:lblDetailTitle	Information	정보	信息
FXPopCoworkContact:lblIsPublic.on	Public	공개	公开
FXPopCoworkContact:lblIsPublicDesc.on	Anyone can view	회원 여부와 관계없이 문서 보기 가능	不管注册与否，均可查看文档
FXPopCoworkContact:lblIsPublic.off	Private	비공개	私人
FXPopCoworkContact:lblIsPublicDesc.off	Only the users who were invited can view	초대 받은 계정으로만 문서 보기 가능	只有被邀请的账户才能查看文档
FXPopCoworkContact:failedRequestAttendee	Failed to request a participants information.	참여자 목록 정보 요청에 실패하였습니다.	参与人列表请求失败！
FXPopCoworkContact:failedAddress	Failed to request an information from address book.	주소록 목록 정보 요청에 실패하였습니다.	通讯录列表请求失败！
FXPopCoworkContact:failedUpdateAttendee	Failed to create a participant list.	참여자 목록 갱신 요청에 실패하였습니다.	参与人列表更新请求失败！
FXPopCoworkContact:failedCreateTask	Failed to share.	공유 생성을 실패하였습니다.	共享创建失败！
FXPopCoworkContact:maxExceeded	Exceeded the max number of invitees.	최대 초대 인원을 초과하였습니다.	已超过最大人数！
FXPopCoworkContact:notEmail	Enter in e-mail format.	이메일 형식으로 입력해주세요.	请输入正确的电子邮箱地址！
FXPopCoworkContact:alreadyAdded	The item is already selected	이미 선택 목록에 포함되어 있습니다.	已包含在选择列表！
FXPopCoworkContact:isHostAccount	Owner cannot be added	문서 소유자는 추가할 수 없습니다.	不能添加文档所有人！
FXPopCoworkContact:failedSelf	Cannot share with yourself.	자기 자신에게는 공유할 수 없습니다.	不能共享给自己！
FXPopCoworkContact:taskShared	Document shared with %@.	%@님에게 문서를 공유하였습니다.	已向 %@ 共享了文档！
FXPopCoworkContact:taskShared2	Document shared with %@ and %d people.	%@님 외 %d명에게 문서를 공유하였습니다.	已向 %@ 外 %d 人共享了文档！
FXPopCoworkContact:taskStopped	Document shared with '%@' has been stopped.	%@'님과 문서 공유가 중단되었습니다.	与 %@ 的文档共享被中断！
FXPopCoworkContact:taskStopped2	Document shared with'%@' and %d people has been stopped.	%@'님 외 %d 명과 문서 공유가 중단되었습니다.	与 %@ 外 %d 人的文档共享被中断！
FXPopCoworkContact:syncAddressAlert	Do you want to import the device's contact list to Polaris Office address book?	현재의 계정으로 단말에 있는 주소록을\n취합합니다. 진행 하시겠습니까?	使用当前账户，把设备上的通讯录进行整合。\n要继续吗？
FXPopCoworkContact:btnClose	Close	닫기	关闭
FXPopCoworkContact:Delete	Delete	삭제	删除
FXPopCoworkContact:Hide	Hide	숨기기	隐藏
			
FXPopCowork:taskUpdate.isPublic.On	Document share setting is Public.	문서 공유 설정을 공개로 변경하였습니다.	文档共享设置已改为公开！
FXPopCowork:taskUpdate.isPublic.Off	Document share setting is Private.	문서 공유 설정을 비공개로 변경하였습니다.	文档共享设置已改为私人！
FXPopCowork:sendSucces_single	Document shared with %@	%@님에게 문서를 공유하였습니다.	已向 %@ 共享了文档！
FXPopCowork:sendSucces_multi	Document shared with %d users excluding %@.	%@님 외 %d명에게 문서를 공유하였습니다.	已向 %@ 外 %d 人共享了文档！
FXPopCowork:invalidTask	You can't access this document.	해당 문서에 접근 권한이 없습니다.	没有权限访问相应文件！
FXPopCowork:invalidAccess	You are not authorized to access the document.	접근 권한이 없습니다.	没有访问权限！
			
FXPopShareVC:sendWeblinkMailBody	%@<%@> has shared '%@' document's link.\n\n%@\n\n\Polaris Office lets you  collaborate with others and edit your documents anytime and anywhere.\""	%@<%@>님이 '%@' 문서의 링크를 공유하였습니다.\n\n%@\n\nPolaris Office를 통해 문서를 기반으로 동료와 커뮤니케이션하고 언제 어디서나 연속적인 문서 작업을 할 수 있습니다.	%@<%@>共享了\%@\"文件链接。\n\n%@\n\nPolaris Office 是基于文件与同事进行沟通，并随时随地可连续处理文件的云办公服务。"
FXPopShareVC:sendWeblinkMailTitle	%@' document's link has been shared.	%@' 문서의 링크를 공유하였습니다.	共享了\%@\"文件链接"
FXPopShareVC:sendWeblinkFacebook	Document has been shared in Polaris Office.	Polaris Office에서 문서를 공유하였습니다.	在 Polaris Office 共享了文件
FXPopShareVC:sendWeblinkTwitter	Document has been shared in Polaris Office.\n%@ %@	Polaris Office에서 문서를 공유하였습니다.\n%@ %@	在 Polaris Office 共享了文件\n%@ %@
FXPopShareVC:Error_AIRPLANE	Please turn off airplane mode to access the data.	데이터에 접근하려면, \n에어플레인 모드를 해제해 주세요.	要访问数据，请先解除飞行模式。
FXPopShareVC:Alert_NetworkDisconnected	Network connection is disabled.\nPlease check your internet connection or Wi-Fi setting.	네트워크 연결이 꺼져 있습니다.\n셀룰러 데이터 또는 Wi-Fi 연결 후\n사용해 주세요.	网络连接已断开！\n请在连接蜂窝移动数据或 Wi-Fi 后使用。
FXPopShareVC:downloading	Downloading...	다운로드 중...	正在下载……
FXPopShareVC:share.kakao.msg	Document has been shared in Polaris Office.	Polaris Office에서 문서를 공유하였습니다.	在 Polaris Office 共享了文件
FXPopShareVC:share.line.msg	Document has been shared in Polaris Office.\n%@	Polaris Office에서 문서를 공유하였습니다.\n%@	在 Polaris Office 共享了文件\n%@ %@
FXPopShareVC:copyToClipboard	Copy to clipboard.	클립보드에 복사되었습니다.	已复制到剪贴板！
FXPopShareVC:btnClose	Close	닫기	关闭
FXPopShareVC:lblTitle	Share Document	문서 공유	文件共享
FXPopShareVC:lblGroupTitle	Share	공유하기	共享
FXPopShareVC:lblLinkTitle	Send Link	링크 보내기	发送链接
FXPopShareVC:lblEmailTitle	Attach to Email	이메일 문서 첨부하기	添加到电子邮件
FXPopShareVC:lblGroup1	Only selected users can access the document	지정된 사용자만 문서에 접근할 수 있습니다.	只有被指定的用户才能访问文件。
FXPopShareVC:lblGroup2	Modified content will be automatically shared	문서를 수정하면 업데이트된 내용이 자동 공유됩니다.	文件被修改时，所更改的内容会被自动共享。
FXPopShareVC:lblGroup3	Sharing can be restricted if necessary	필요하면 공유를 취소하여 접근 못하게 할 수 있습니다.	必要时可以取消共享，禁止访问。
FXPopShareVC:lblLink1	Anyone with the link can view the document	링크를 알고 있는 사용자는 누구나 문서를 볼 수 있습니다.	知道链接的用户，都可以查看文件。
FXPopShareVC:lblLink2	People without an office program can also view the document	오피스 프로그램이 없더라도 문서를 볼 수 있습니다.	没有安装 Office 程序也能查看文件。
FXPopShareVC:lblLink3	You may unlink the document if necessary	필요하면 링크를 해제하여 접근 못하게 할 수 있습니다.	必要时可以解除链接，禁止访问。
FXPopShareVC:lblEmail1	Send document by email	이메일로 문서 파일을 전달합니다.	通过电子邮件传送文件。
FXPopShareVC:lblEmail2	You cannot cancel sending.	전달된 문서는 회수하거나 취소할 수 없습니다.	已发送的文件不能回收或取消。
FXPopShareVC:lblEmail3	Large files may not be sent.	파일 용량에 따라 전달이 되지 않을 수 있습니다.	根据文件大小，有可能无法传送。
FXPopShareVC:exceptionZip	ZIP files cannot be shared	압축 파일은 공유하거나 링크 보내기 할 수 없습니다.	ZIP文件不能被共享或者通过链接发送。
FXPopShareVC:exceptionPcloud	You need to synchronize the document first to share it.	동기화되지 않은 문서는 공유하거나 링크 보내기 할 수 없습니다.	不同步的文件不能被共享或通过链接发送。
FXPopShareVC:exceptionGuest	A dcoument shared by other party cannot be distributed by email or link.	공유받은 문서는 링크를 보내거나 메일 전송 할 수 없습니다.	收到的共享文件可以不通过电子邮件或链接被发送。
			
FXPCloudLoginVC:login	Sign In	로그인	登录
FXPCloudLoginVC:join	Sign Up	회원가입	注册会员
FXPCloudLoginVC:title_1	Easy Documentation	쉬운 문서 편집	轻松完成文档编辑
FXPCloudLoginVC:title_2	Always Up-To-Date	어디서든 빠른 문서 확인	文档确认更快捷
FXPCloudLoginVC:title_3	Various Cloud Service	다양한 클라우드 서비스 연동	联动云服务
FXPCloudLoginVC:title_4		환영합니다!	欢迎您！
FXPCloudLoginVC:title_5		종이 없는 회의	无纸会议
FXPCloudLoginVC:title_6		손쉬운 문서 작업	轻松完成文档编辑
FXPCloudLoginVC:title_7		편리한 문서 공유	文档共享超方便
FXPCloudLoginVC:body_1	View, Edit and Share Documents	모바일 기기에서 문서를 보고 편집할 수 있습니다	可以在手机或平板电脑上查看和编辑文档。
FXPCloudLoginVC:body_2	Save your work,\nit's updated on all connected device	저장한 문서는 모든 디바이스에 최신 상태로 유지 됩니다	保存的文档会在所有设备上保持最新状态。
FXPCloudLoginVC:body_3	Supports connect to multiple\nCloud Services at the same time	클라우드에 저장한 문서를 자유롭게 이용할 수 있습니다	您可以使用各种云服务
FXPCloudLoginVC:body_4		로그인 한번으로 모든 기기에서\n문서를 자유롭게 확인할 수 있습니다	一次登录即可在所有设备上自由查看文档。
FXPCloudLoginVC:body_5		프로젝터나 인쇄물 없이도 사람들과 각자의 모바일 기기로\n같은 문서를 보면서 회의를 할 수 있습니다	无需进行繁琐的幻灯片打印，即可在各自的设备上同步播放幻灯片。
FXPCloudLoginVC:body_6		모바일에서도 PC처럼 문서를 보고 편집할 수 있습니다	在移动设备上也能像 PC 一样查看和编辑文档。
FXPCloudLoginVC:body_7		문서를 공유하고 내용에 대해서 자유롭게 이야기 하세요	向好友、同事共享自己的文档，在线讨论文档内容。
FXPCloudLoginVC:body_1_p	View, Edit and Share Documents	모바일 기기에서 문서를 보고 편집할 수 있습니다	可以在手机或平板电脑上查看和编辑文档。
FXPCloudLoginVC:body_2_p	Save your work,\nit's updated on all connected device	저장한 문서는 모든 디바이스에 \n최신 상태로 유지 됩니다	保存的文档会在所有设备上保持最新状态。
FXPCloudLoginVC:body_3_p	Connect to your cloud services and manage documents	클라우드에 저장한 문서를 자유롭게 이용할 수 있습니다	您可以使用各种云服务
FXPCloudLoginVC:body_4_p		로그인 한번으로 모든 기기에서\n문서를 자유롭게 확인할 수 있습니다	一次登录即可在所有设备上自由查看文档。
FXPCloudLoginVC:body_5_p		프로젝터나 인쇄물 없이도 사람들과\n각자의 모바일 기기로 같은 문서를 보면서\n회의를 할 수 있습니다	无需进行繁琐的幻灯片打印，\n即可在各自的设备上同步播放幻灯片。
FXPCloudLoginVC:body_6_p		모바일에서도 PC처럼\n문서를 보고 편집할 수 있습니다	在移动设备上也能像 PC 一样查看和编辑文档。
FXPCloudLoginVC:body_7_p		문서를 공유하고 내용에 대해서\n자유롭게 이야기 하세요	向好友、同事共享自己的文档，在线讨论文档内容。
			
FSettingDevice:lastAccessTime	Last Connection : %@	마지막 접속: %@	上次访问时间：%@
FSettingDevice:lastAccessTime.dateformat	yyyy/MM/dd HH:mm	yyyy/MM/dd HH:mm	yyyy/MM/dd HH:mm
FSettingDevice:disconnectDevice	Do you want to disconnect'%@'\n?	%@'\n연결을 해제하시겠습니까?	%@\n要解除连接吗？
FSettingDevice:disconnectDeviceFail	Fail to disconnect the device	디바이스 연결 해제에 실패하였습니다.	设备连接解除失败！
			
PopCoworkLink:lblDescription	Create a public link for everyone to view the document..	누구나 문서를 볼 수 있도록 공개 링크를 생성하여 메일로 보내거나 웹에 게시할 수 있습니다.	可生成公开链接，以电子邮件发送或提交到网络，任何人都能在线查看相应文档。
PopCoworkLink:btnCopy	Copy	복사하기	复制
			
FXSettingRecommendVC:lblDesc1Phone	Invite a friend and you will both get 100MB of extra space when they register. (Max 600MB)	Polaris Office에 친구나 동료를\n초대하고, 최대 600MB의 보너스 용량을 받으세요.	邀请好友或同事，\n获赠最多 600MB 的奖励空间。
FXSettingRecommendVC:lblDesc1	Invite a friend and you will both get 100MB of extra space when they register. (Max 600MB)	Polaris Office에 친구나 동료를 초대하고,\n최대 600MB의 보너스 용량을 받으세요.	邀请好友或同事，获赠最多 600MB 的奖励空间。
FXSettingRecommendVC:lblDesc2	Invite a friend and you will both get 100MB of extra space when they register. (Max 600MB)	나와 초대로 가입한 사람에게 100MB의 보너스 용량을 제공합니다. (최대 600MB)	我和接受我的邀请注册的用户可获得 100MB 奖励空间。(最多 600MB)
FXSettingRecommendVC:btnEmail	Email	이메일	电子邮件
FXSettingRecommendVC:btnFacebook	Facebook	페이스북	Facebook
FXSettingRecommendVC:btnTwitter	Twitter	트위터	Twitter
FXSettingRecommendVC:lblIntroduce	Introduce By	소개하기	介绍
FXSettingRecommendVC:btnKakao	Kakao	카카오톡	KakaoTalk
FXSettingRecommendVC:btnLine	Line	라인	Line
			
FXSettingRecMainVC:lblExplain	Get More Storage To Store More Documents	더 많은 문서를 저장하기 위해 용량을 추가해 보세요.	您可以增加容量，存储更多文档。
FXSettingRecMainVC:lblExplainP	Get More Storage To Store More Documents	더 많은 문서를 저장하기 위해\n용량을 추가해 보세요.	您可以增加容量，\n存储更多文档。
FXSettingRecMainVC:titleUpgrade	Upgrade Your Account	계정을 업그레이드 해보세요.	您可以升级您的账户。
FXSettingRecMainVC:titleRecommend	Invite Your Friends	친구, 가족, 동료들에게 추천해 보세요.	您可以推荐给好友和同事。
FXSettingRecMainVC:titleInstall	Install PC App	PC용 App을 설치해 보세요.	您可以安装 PC 客户端。
FXSettingRecMainVC:lblUpgrade	Upgrade to premium and get 5GB of additional storage, sync up to 5 devices, and more	Premium 계정이 되시면 5GB의 추가용량 뿐만 아니라,\n보안, 기기 추가 등 다양한 기능을 경험하실 수 있습니다.	升级到高级账户时，不仅能获得 5GB 的额外容量，\n还能获得安全、设备增加等丰富的新功能。
FXSettingRecMainVC:lblRecommend	Invite your friends and you will both earn an additional 100MB storage.	초대한 사람과 초대로 가입한 사람 모두에게\n100MB의 보너스 용량을 제공합니다.	发送邀请和接受邀请后注册的用户，\n都能获得 100MB 的奖励空间。
FXSettingRecMainVC:lblInstall	Install desktop app for windows and earn an additional 300MB of storage.	지금 설치하시면 300MB의 보너스 용량과\n문서를 더욱 쉽고 빠르게 업/다운로드 할 수 있습니다.	现在安装即可获得 300MB 的奖励空间，\n能更快捷地进行文档下载和上传。
FXSettingRecMainVC:lblUpgradePhone	Upgrade to premium and get 5GB of additional storage, sync up to 5 devices, and more	Premium 계정이 되시면 5GB의\n추가용량 뿐만 아니라, 보안, 기기 추가 등\n다양한 기능을 경험하실 수 있습니다.	升级到高级账户时，\n不仅能获得 5GB 的额外容量，\n还能获得安全、设备增加\n等丰富的新功能。
FXSettingRecMainVC:lblRecommendPhone	Invite your friends and you will both earn an additional 100MB storage.	초대한 사람과 초대로 가입한 사람\n모두에게 100MB의 보너스 용량을\n제공합니다.	发送邀请和接受邀请后注册的用户，\n都能获得 100MB 的奖励空间。
FXSettingRecMainVC:lblInstallPhone	Install desktop app for windows and earn an additional 300MB of storage.	지금 설치하시면 300MB의 보너스 용량과\n문서를 더욱 쉽고 빠르게 업/다운로드\n할 수 있습니다.	现在安装即可获得 300MB 的奖励空间，\n能更快捷地进行文档下载和上传。
FXSettingRecMainVC:btnUpgrade	Upgrade Account >	계정 업그레이드 하기 >	升级账户 >
FXSettingRecMainVC:btnRecommend	Invite Now >	지금 추천하기 >	马上推荐>
FXSettingRecMainVC:btnInstall	Install Now >	이메일로 다운로드 링크 보내기 >	马上确认>
FXSettingRecMainVC:requesting	Requesting...	요청 중에 있습니다.	要求...
FXSettingRecMainVC:sendComplete	Email sent	메일 전송이 완료 되었습니다.	发送电子邮件已经完成。
FXSettingRecMainVC:Error_AIRPLANE	Please turn off airplane mode to access the data.	데이터에 접근하려면, \n에어플레인 모드를 해제해 주세요.	要访问数据，请先解除飞行模式。
FXSettingRecMainVC:LinkError	The network is busy.\nPlease try it again later.	네트워크 상태가 원활하지 않습니다.\n잠시 후 다시 시도해 주세요.	网络状态不稳定，请稍后再试
			
FXSettingRecListCell:premium	Service Introduction >	서비스 소개 >	业务介绍>
FXSettingRecListCell:upgrade	Upgrade account >	계정 업그레이드 하기 >	升级账户>
			
FXMessengerVC:titleLabel	Notifications	알림	通知
			
FXNoticeSyncVC:synchonized	Synchronized	동기화 완료	完成同步
FXNoticeSyncVC:performSynchonized	Synchronizing...	동기화 중	正在同步
FXNoticeSyncVC:disconnected	Disconnected	네트워크 연결 안됨	无法连接网络
			
FXSettingEditInfoVC:lblName	Change your name.	이름을 변경합니다.	更改姓名
FXSettingEditInfoVC:lblPassword	Change your password.	비밀번호를 변경합니다.	更改密码
FXSettingEditInfoVC:firstName	Full name	성명	名
FXSettingEditInfoVC:lastName	Last name	성	姓
FXSettingEditInfoVC:password	Password	비밀번호	密码
FXSettingEditInfoVC:btnDone	Done	확인	确认
FXSettingEditInfoVC:curPassword	Current Password	현재 비밀번호	当前密码
FXSettingEditInfoVC:newPassword	New Password	새 비밀번호	新密码
FXSettingEditInfoVC:conPassword	Confirm Password	비밀번호 확인	确认密码
FXSettingEditInfoVC:changeComplete	Changed	변경이 완료 되었습니다.	完成更改
FXSettingEditInfoVC:againPassword	Enter new password again.	새로운 비밀번호를 다시 입력해 주시기 바랍니다.	请重新输入新密码
FXSettingEditInfoVC:sameName	It cannot be changed to the same information.	동일한 정보로 변경할 수 없습니다.	不能改为相同内容
FXSettingEditInfoVC:checkInputInfo	Please check the input information.	입력된 정보를 확인해 주시기 바랍니다.	请确认所输入的信息
FXSettingEditInfoVC:alertPreventFirstName	First name cannot contain special characters or numbers.	성에 특수문자나 숫자는\n입력할 수 없습니다.	不能包含特殊字符或数字
FXSettingEditInfoVC:alertPreventLastName	Last name cannot contain special characters or numbers.	이름에 특수문자나 숫자는\n입력할 수 없습니다.	不能包含特殊字符或数字。
FXSettingEditInfoVC:NotUseSpecialCharacters	Special characters (/, :, *, ?, <, >, |, \, and \) cannot be used.	이름에 특수문자나 숫자는 입력할 수 없습니다.	不能使用特殊字符 (\\ / : * ? \ “ < > |)！
FXSettingEditInfoVC:maxLength	Username cannot exceed 30 characters.	사용자 이름은 최대 30자까지 입력할 수 있습니다.	用户名最多可以有30个字符。
FXSettingEditInfoVC:lblPasswordSetup	Set your password	비밀번호를 설정합니다	设置密码
			
USNSSender:SNSNameFacebook	Facebook	페이스북	Facebook
USNSSender:SNSNameTwitter	Twitter	트위터	Twitter
USNSSender:SNSCompletePost	Posted	게시가 완료되었습니다.	已发送
			
FXLockSettingVC:formatMinute	%dMin	%d분	%d分
FXLockSettingVC:formatSecond	%dSec	%d초	%d秒
FXLockSettingVC:formatNow	Immediately	즉시	立即
FXLockSettingVC:btnSetup	Passcode	잠금 번호 설정	设置锁定密码
FXLockSettingVC:btnChange	Change Passcode	잠금 번호 변경	更改锁定密码
FXLockSettingVC:btnClear	Disable Passcode	잠금 번호 해제	注销锁定密码
FXLockSettingVC:lblLockActiveTime	Require Passcode	백그라운드 잠금 시간 설정	设置后台锁定时间
FXLockSettingVC:lblText	You will be automatically logged out if you enter the passcode incorrectly five consecutive times.	5회 이상 암호가 일치하지 않을 시 자동 로그아웃 됩니다	密码输入错误次数达到 5 次时，会被自动退出登录。
			
FXPopLockVC:lblTitle	Passcode	Passcode	Passcode
FXPopLockVC:forceLogout	You will be logged out\nbecause the passcode entered is incorrect.	잠금 번호에 잘못 접근하여 로그아웃 합니다.	由于锁定密码访问错误，将要退出登录。
FXPopLockVC:btnLogout	Log Out	로그아웃	退出登录
FXPopLockVC:btnCancel	Cancel	취소	取消
FXPopLockVC:alert5Count	You will be automatically logged out if you enter the passcode incorrectly five consecutive times.	5회 이상 암호가 일치하지 않아 자동 로그아웃 됩니다.	由于密码输入错误次数达到 5 次，将要自动退出登录。
FXPopLockVC:alertWrongCode	You have entered an incorrect passcode.	잠금 번호가 잘못 입력되었습니다.	锁定密码输入错误！
FXPopLockVC:alertClear	The passcode feature has been disabled.	잠금번호가 해제되었습니다.	锁定密码已被注销
FXPopLockVC:alertSetupComplete	The passcode has been changed.	새로운 잠금번호가 설정되었습니다.	已设置新锁定密码
FXPopLockVC:alertDifferentCode	The passcode is incorrect.	잠금 번호가 일치하지 않습니다.	锁定密码错误！
FXPopLockVC:titleConfirm	Enter your passcode	암호 입력	确认锁定密码
FXPopLockVC:titleSetup1	Enter a new passcode	새로운 번호 입력	输入新密码
FXPopLockVC:titleSetup2	Confirm Passcode	잠금 번호 확인	确认锁定密码
FXPopLockVC:textLock	You will be automatically logged out if you enter the  passcode incorrectly five consecutive times.	5회 이상 암호가 일치하지 않을 시 자동 로그아웃 됩니다	密码输入错误次数达到 5 次时，会被自动退出登录。
			
MPeopleVC:syncAddressAlert	Do you want to import the device's contact list to Polaris Office address book?	현재의 계정으로 단말에 있는 주소록을\n취합합니다. 진행 하시겠습니까?	使用当前账户，把设备上的通讯录进行整合。\n要继续吗？
			
MMsgController:ContactAccessAlert	To change access settings of the address book, please go to Privacy > Contacts > Polaris Office.	주소록 접근 설정을 변경하고 싶으시면 개인 정보 보호 > 연락처 > Polaris Office 설정을 활성화 해주세요.	如需更改通讯录访问设置，请在设备的\设置\">\"隐私\">\"通讯录\"中进行设置。"
			
FXInfoShareVC:lblOwner	Owner	소유자	所有人
FXInfoShareVC:lblShareGroup	Shared Group	공유된 그룹	共享组
FXInfoShareVC:lblPublic.on	Public	공개	公开
FXInfoShareVC:lblPublic.off	Private	비공개	私人
FXInfoShareVC:lblPublicDetail.on	Anyone can view	회원여부와 관계없이 문서 보기 가능	不管注册与否，均可查看文档
FXInfoShareVC:lblPublicDetail.off	Only the users who were invited can view	초대 받은 계정으로만 문서 보기 가능	只有被邀请的账户才能查看文档
FXInfoShareVC:btnDeleteShareGroup	Unshare	공유 해제	取消共享
FXInfoShareVC:lblGroupNFormat	%d users excluding %@	%@외 %d명	已向 %@ 外 %d 人
FXInfoShareVC:lblDeleteShareGroup	Do you want to unshare %@?	%@의 공유를 해제하시겠습니까?	%@您确定要禁用共享？
			
FXAccountVC:lblGradeUsage	Service Subscriber	서비스 사용중	服务使用中
FXAccountVC:lblFree	Free	Free	免费
FXAccountVC:lblPremium	Premium	Premium	高级
FXAccountVC:btnUpgrade	Upgrade Account	계정 업그레이드	升级账户
FXAccountVC:btnPremium	Service Introduction	서비스 소개	业务介绍
FXAccountVC:lblDueDate	Available until	까지 이용가능	到期
FXAccountVC:lblEdit	Edit	편집	编辑
FXAccountVC:btnLogout	Log Out	로그아웃	退出登录
FXAccountVC:lblStorageTitle	STORAGE SPACE	저장 공간	云盘空间
			
FXSettingPOSInfoVC:lblDesc	You received additional 300MB of storage for installing Polaris Office Sync. \nNow you can easily and quickly sync and download your documents onto other devices.	Desktop용 Polaris Office를 설치하여 300MB의 보너스 용량과\n문서를 더욱 쉽고 빠르게 업/다운로드 할 수 있습니다.	在您的计算机上安装 Polaris Office Sync，即可获赠 300MB 存储空间，\n同时文档上传和下载也会变得更轻松。
FXSettingPOSInfoVC:lblDescP	You received additional 300MB of storage for installing Polaris Office Sync. Now you can easily and quickly sync and download your documents onto other devices.	Desktop용 Polaris Office를 설치하여 300MB의 보너스 용량과 문서를 더욱 쉽고 빠르게 업/다운로드 할 수 있습니다.	在您的计算机上安装 Polaris Office Sync，即可获赠 300MB 存储空间，同时文档上传和下载也会变得更轻松。
FXSettingPOSInfoVC:lblDescPoint	300MB	300MB	300MB
FXSettingPOSInfoVC:lblTitleInstall	How to Install	설치방법	安装方法
FXSettingPOSInfoVC:lblDescIns1	A download link is being sent to your registered email account.	현재 회원님의 이메일 주소로 다운로드 링크가 전달 중입니다.	正在向您的邮箱地址发送下载链接。
FXSettingPOSInfoVC:lblDescIns2	Open the email titled, 'Polaris Office Sync Download,' on your PC.	Desktop에서 'Polaris Office 다운로드' 이메일을 확인하세요.	请在您的计算机上查收标题为"下载 Polaris Office Sync"的邮件。
FXSettingPOSInfoVC:lblDescIns3	Please click on the link provided in your email	메일의 다운로드 링크를 선택하세요.	请点击邮件内的下载链接。
FXSettingPOSInfoVC:lblDescIns4	Please install Polaris Office Sync for PC.	Desktop용 Polaris Office를 설치하세요.	请安装 Polaris Office Sync。
FXSettingPOSInfoVC:btnClose	Close	닫기	关闭
			
FXPChangeDeviceVC:lblTitle.manage	Manage linked devices	연동 기기 관리	管理已连接设备
FXPChangeDeviceVC:btnPremium	Upgrade account	계정 업그레이드	升级账户
FXPChangeDeviceVC:btnDisconnect	Disconnect linked devices	연동 기기 해제	解除设备连接
FXPChangeDeviceVC:lblDescription	Upgrade your account to \nadd more devices or clear a device from your device list.	계정을 업그레이드하여 연동 기기를 \n추가하거나계정을 업그레이드하여 연동 기기를 \n추가하거나, 디바이스 관리를 눌러 \n다른 기기를 정리해 주세요.\n다른 기기를 정리해 주세요.	请升级账户增加要连接的设备数量，或点击设备管理，对已连接设备进行整理。
			
FXPDeviceVC:lblTitle.disconnect	Disconnect linked devices	연동 기기 해제	解除设备连接
FXPDeviceVC:lblDescription	Please choose a device to disconnect.	해제할 기기를 선택하세요.	请选择要解除连接的设备。
FXPDeviceVC:disconnectDevice	Disconnecting the selected device:\n'[%@]'\nDo you want to continue?	선택한 ['%@']\n기기의 연결을 해제합니다.\n계속할까요?	将要解除已选中的 [%@] 连接，要继续
			
FXPPageVC:title_1	Easy Documentation	쉬운 문서 편집	轻松完成文档编辑
FXPPageVC:title_2	Always Up-To-Date	어디서든 빠른 문서 확인	文档确认更快捷
FXPPageVC:title_3	Various Cloud Service	다양한 클라우드 서비스 연동	联动云服务
FXPPageVC:body_1	View, Edit and Share Documents	모바일 기기에서 문서를 보고 편집할 수 있습니다	可以在手机或平板电脑上查看和编辑文档。
FXPPageVC:body_2	Save your files once, all edits will be updated on your other devices	저장한 문서는 모든 디바이스에 최신 상태로 유지 됩니다	保存的文档会在所有设备上保持最新状态。
FXPPageVC:body_3	Supports connect to multiple Cloud Services at the same time	클라우드에 저장한 문서를 자유롭게 이용할 수 있습니다	您可以使用各种云服务
FXPPageVC:body_1_p	View, Edit and Share Documents	모바일 기기에서 문서를 보고 편집할 수 있습니다	可以在手机或平板电脑上查看和编辑文档。
FXPPageVC:body_2_p	Save your work,\nit's updated on all connected device	저장한 문서는 모든 디바이스에 \n최신 상태로 유지 됩니다	保存的文档会在所有设备上保持最新状态。
FXPPageVC:body_3_p	Connect to your cloud services and manage documents	클라우드에 저장한 문서를 자유롭게 이용할 수 있습니다	您可以使用各种云服务
			
FXPLoginVC:login	Sign In	로그인	登录
FXPLoginVC:lblPolarisID	Email	이메일	账户
FXPLoginVC:lblPolarisPW	Password	비밀번호	密码
FXPLoginVC:btnLogin	Sign In	로그인	登录
FXPLoginVC:btnFind	Find Password	비밀번호 찾기	找回密码
			
FXPAccountVC:alertLoginTitle	Notification	알림	通知
FXPAccountVC:alertLoginOK	You are now logged on Polaris Office	Polaris Office 로그인이 되었습니다.	已登录 Polaris Office
FXPAccountVC:alertLoginFail	This e-mail is not registered, or the e-mail address / password you entered is incorrect.	등록되지 않은 이메일이거나, 이메일 또는 비밀번호를 잘못 입력하였습니다.	未注册的电子邮箱地址，或电子邮箱地址或密码输入错误！
FXPAccountVC:alertPreventPasswd8	You have entered an incorrect password\n%d consecutive times.\nIf you enter an incorrect password 10 consecutive times,\nthen you have to reset your password.	비밀번호를 연속으로 %d회\n 잘못 입력하였습니다.\n연속으로 10회 잘못 입력할 경우 \n비밀번호를 재설정해야 합니다.	已连续 %d 次错误输入密码！\n连续错误输入 10 次后，需要重设密码。
FXPAccountVC:alertPreventPasswd10	You have entered an incorrect password\n10 consecutive times.\nPlease reset your password.	비밀번호를 연속으로 \n10회 잘못 입력하였습니다.\n비밀번호를 재설정 해 주세요.	密码连续错误输入 10 次！\n请重设密码。
FXPAccountVC:alertDeletedAccount	This account has already been deleted. To reuse this username, please wait 7 days.	이미 탈퇴한 계정입니다.\n 이 계정은 탈퇴 7일 이후에 \n 사용할실 수 있습니다.	已注销服务的用户名，注销 7 日后可以重新使用。
FXPAccountVC:alertJoinTitle	Notification	알림	通知
FXPAccountVC:alertExistEmail	This ID is already registered.\n Please try signing in.	이미 가입된 계정입니다.\n로그인으로 해주세요.	已注册过的账户！\n请直接登录。
FXPAccountVC:PopAlert.errorUserInfo	Failed to connect to your Facebook account.	Facebook 정보를 받아오는데 실패하였습니다.	获取 Facebook 信息失败。
FXPAccountVC:onlyFacebook	Select the Facebook sign in button to log in to your account.	페이스북 계정 로그인 버튼을 선택하여 로그인하세요.	请点击"用Facebook账户登录"按钮进行登录。
			
FXPFindPWVC:lblTitle.FindPW	Find Password	비밀번호 찾기	找回密码
"FXPFindPWVC:lblBody	Please enter your e-mail address to receive a password to reset the account.\n If you do not receive this e-mail in a few minutes, please press \"Resend\".\n Please check your spam mail folder before resending the request.	비밀번호 재설정을 위해 Polaris Office 계정의 이메일\n주소를 입력해 주시면 안내 메일을 보내드립니다.	请输入 Polaris Office 账户的电子邮箱地址，系统向所输入的电子邮箱发送重设密码向导邮件。
FXPFindPWVC:lblSubTitle	Did you forget your password?	비밀번호를 잊으셨나요?	忘记密码了？
FXPFindPWVC:btnCommit	Send	보내기	发送
FXPFindPWVC:tfEmail.placeholder	Enter E-mail	E-mail 입력	输入电子邮箱地址
FXPFindPWVC:toastFindPassword	Your password has been sent to\n %@.	%@'로\n 메일이 전송되었습니다.	已向 %@ 发送邮件！
			
FXPCreateAccountVC:lblTitle.Join	Sign up	회원 가입	注册会员
FXPCreateAccountVC:lblFirstName	First Name	이름	名
FXPCreateAccountVC:lblID	Email	이메일	账户
FXPCreateAccountVC:lblPW	Password	비밀번호	密码
FXPCreateAccountVC:wvAgree	I agree to Polaris Office <a href=\"https://www.Polarisoffice.com/view/rules\">Terms of Service</a> and <a href=\"https://www.Polarisoffice.com/view/privacy\">Privacy policy</a>.	Polaris Office의 <a href=\"https://www.Polarisoffice.com/view/rules\">이용약관</a>과 <a href=\"https://www.Polarisoffice.com/view/privacy\">개인정보 수집 및 이용</a>에 동의합니다.	我同意 Polaris Office 的<a href=\"https://link.Polarisoffice.com/view/rules\">服务条款</a>和<a href=\"https://link.Polarisoffice.com/view/privacy\">隐私政策</a>。
FXPCreateAccountVC:lblJoin	Sign up	가입하기	注册
			
FXPComponentVC:alertPreventEmail	Please enter your e-mail address in the correct format.	이메일 형식으로\n입력해 주세요.	请以电子邮箱地址格式输入！
FXPComponentVC:alertPreventPassword	Password must consist of 4 to 20 English letters and numbers.	비밀번호는 영문과 숫자를 혼용하여\n4~20자로 입력해 주세요.	密码需要包含 4~20 个英文字符和数字！
			
FXPMergeAccountVC:lblTitle.Merge	Merge account	계정 통합(%@)	合并账户
FXPMergeAccountVC:lblMerge	Merge	통합하기	合并
FXPMergeAccountVC:PopAlert.errorFacebookEmail	You cannot create new account because the email is not registered in your facebook account.	Facebook 계정에 이메일이 등록되지 않아 회원 가입을 할 수 없습니다.	发送电子邮件的Facebook帐户没有注册，则不能注册。
FXPMergeAccountVC:lblFBGuide.Merge	Sign Up using Facebook account to create Polaris Office account. \n Please create a password for Polaris Office.	기존 Polaris Office 계정을 Facebook과\n통합합니다.Polaris Office 계정 비밀번호를\n입력해주세요.	这将编译的Facebook到目前的Polaris Office帐户。 \n 请将输入密码。
FXPMergeAccountVC:lblFBGuide.Join	Sign Up using Facebook account to create Polaris Office account. \n Please create a password for Polaris Office.	Facebook으로 Polaris Office를 시작합니다.	启动Polaris Office被Facebook。 \ n请将输入密码从Polaris Office帐户才能使用。
FXPMergeAccountVC:lblTitle.FBJoin	Sign Up(%@)	회원 가입(%@)	注册会员(%@)
FXPMergeAccountVC:PopAlert.errorUserInfo	Failed to bring the information from Facebook.	Facebook 정보를 받아오는데 실패하였습니다.	无法使Facebook的信息。
FXPMergeAccountVC:wvAgree	I agree to Polaris Office <a href=\"https://www.Polarisoffice.com/view/rules\">Terms of Service</a> and <a href=\"https://www.Polarisoffice.com/view/privacy\">Privacy policy</a>.	Polaris Office의 <a href=\"https://www.Polarisoffice.com/view/rules\">이용약관</a>과 <a href=\"https://www.Polarisoffice.com/view/privacy\">개인정보 수집 및 이용</a>에 동의합니다.	我同意 Polaris Office 的<a href=\"https://link.Polarisoffice.com/view/rules\">服务条款</a>和<a href=\"https://link.Polarisoffice.com/view/privacy\">隐私政策</a>。
			
FXPLoginEntranceVC:PopAlert.FailLogin	Failed to sign in with Facebook	Facebook 로그인 실패	Facebook 登录失败！
FXPLoginEntranceVC:PopAlert.DeniedLogin	Failed to connect to FaceBook account. \n Please allow access permission under your Facebook account settings.	Facebook 연결이 실패하였습니다.\n사용자의 Facebook 계정에서 접근 권한을 허용해 주십시오.	Facebook的连接失败。\n 您的Facebook帐户，以允许访问它。
FXPLoginEntranceVC:PopAlert.CancelText	Done	확인	确认
FXPLoginEntranceVC:startFB	Starting by Facebook	Facebook으로 시작하기	使用 Facebook 启动
FXPLoginEntranceVC:createAccount	Sign up	계정 만들기	注册
FXPLoginEntranceVC:login	Sign In	로그인	登录
FXPLoginEntranceVC:Description	Polaris Office never posts on your timeline \n unless it is requested by you.	Polaris Office는 회원님의 요청이 없는\n한 어떠한 내용도 타임라인에 게시하지 않습니다.	在没有得到您的请求的情况下，\nPolaris Office 不会把任何内容发布到时间线。
			
FXPStartVC:startNow	Get Started	지금 시작하기	立即进入
FXPStartVC:detailView	View Features	자세히 보기	查看介绍
FXPStartVC:mainTitle	Organize and share your documents anytime, anywhere	어디서나 생각을 정리하고\n공유해 보세요.	整理思维 自由共享
			
FXSelDocumentVC:Scan	Scan	문서스캔	扫描
			
			
			
			
			
			
			
			
			
			
			
			
			
			
			
			
			
			
			
			
			
			
			
			
			
			
			
			
			
			
			
			
			
			
			
			
			
			
			
			
			
			
			
			
			
			
			
			
			
			
			
			
			
			
			
			
			
			
			
			
			
			
			
			
			
			
			
			
			
			
			
			
			
			
			
			
			
			
			
			
			
			
			
			
			
			
			
			
			
			
			
			
			
			
			
			
			
			
			
			
			
			
			
			
			
			
			
			
			
			
			
			
			
			
			
			
			
			
			
			
			
			
			
			
			
			
			
			
			
			
			
			
			
			
			
			
			
			
			
			
			
			
			
			
			
			
			
			
			
			
			
			
			
			
			
			
			
			
			
			
			
			
			
			
			
			
			
			
			
			
			
			
			
			
			
			
			
			
			
			
			
			
			
			
			
			
			
			
			
			
			
			
			
			
			
			
			
			
			
			
			
			
			
			
			
			
			
			
			
			
			
			
			
			
			
			
			
			
			
			
			
			
			
			
			
			
			
			
			
			
			
			
			
			
			
			
			
			
			
			
			
			
			
			
			
			
			
			
			
			
			
			
			
			
			
			
			
			
			
			
			
			
			
			
			
			
			
			
			
			
			
			
			
			
			
			
			
			
			
			
			
			
			
			
			
			
			
			
			
			
			
			
			
			
			
			
			
			
			
			
			
			
			
			
			
			
			
			
			
			
			
			
			
			
			
			
			
			
			
			
			
			
			
			
			
			
			
			
			
			
			
			
			
			
			
			
			
			
			
			
			
			
			
			
			
			
			
			
			
			
			
			
			
			
			
			
			
			
			
			
			
			
			
			
			
			
			
			
			
			
			
			
			
			
			
			
			
			
			
			
			
			
			
			
			
			
			
			
			
			
			
			
			
			
			
			
			
			
			
			
			
			
			
			
			
			
			
			
			
			
			
			
			
			
			
			
			
			
			
			
			
			
			
			
			
			
			
			
			
			
			
			
			
			
			
			
			
			
			
			
			
			
			
			
			
			
			
			
			
			
			
			
			
			
			
			
			
			
			
			
			
			
			
			
			
			
			
			
			
			
			
			
			
			
			
			
			
			
			
			
			
			
			
			
			
			
			
			
			
			
			
			
			
			
			
			
			
			
			
			
			
			
			
			
			
			
			
			
			
			
			
			
			
			
			
			
			
			
			
			
			
			
			
			
			
			
			
			
			
			
			
			
			
			
			
			
			
			
			
			
			
			
			
			
			
			
			
			
			
			
			
			
			
			
			
			
			
			
			
			
			
			
			
			
			
			
			
			
			
			
			
			
			
			
			
			
			
			
			
			
			
			
			
			
			
			
			
			
			
			
			
			
			
			
			
			
			
			
			
			
			
			
			
			
			
			
			
			
			
			
			
			
			
			
			
			
			
			
			
			
			
			
			
			
			
			
			
			
			
			
			
			
			
			
			
			
			
			
			
			
			
			
			
			
			
			
			
			
			
			
			
			
			
			
			
			
			
			
			
			
			
			
			
			
			
			
			
			
			
			
			
			
			
			
			
			
			
			
			
			
			
			
			
			
			
			
			
			
			
			
			
			
			
			
			
			
			
			
			
			
			
			
			
			
			
			
			
			
			
			
			
			
			
			
			
			
			
			
			
			
			
			
			
			
			
			
			
			
			
			
			
			
			
			
			
			
			
			
			
			
			
			
			
			
			
			
			
			
			
			
			
			
			
			
			
			
			
			
			
			
			
			
			
			
			
			
			
			
			
			
			
			
			
			
			
			
			
			
			
			
			
			
			
			
			
			
			
			
			
			
			
			
			
			
			
			
			
			
			
			
			
			
			
			
			
			
			
			
			
			
			
			
			
			
			
			
			
			
			
			
			
			
			
			
			
			
			
			
			
			
			
			
			
			
			
			
			
			
			
			
			
			
			
			
			
			
			
			
			
			
			
			
			
			
			
			
			
			
			
			
			
			
			
			
			
			
			
			
			
			
			
			
			
			
			
			
			
			
			
			
			
			
			
			
			
			
			
			
			
			
			
			
			
			
			
			
			
			
			
			
			
			
			
			
			
			
			
			
			
			
			
			
			
			
			
			
			
			
			
			
			
			
			
			
			
                
